Date,Description,Credit,Debit,Balance,Amount
15/05/2021,DISNEY PLUS - Visa Purchase - Receipt 170476In RICHMOND Date 13 May 2021 Card 462263xxxxxx7746,,-8.99,7757.2,8.99
15/05/2021,MCDONALDS MURRUMBA DO - Visa Purchase - Receipt 170475In MURRUMBA DOW Date 12 May 2021 Card 462263xxxxxx7746,,-14.8,7766.19,14.8
15/05/2021,ALDI STORES - KALLANGU - Visa Purchase - Receipt 170474In KALLANGUR Date 12 May 2021 Card 462263xxxxxx7746,,-54.78,7780.99,54.78
15/05/2021,Woolworths Online - Visa Purchase - Receipt 170473In BELLA VISTA Date 14 May 2021 Card 462263xxxxxx7746,,-33.05,7835.77,33.05
15/05/2021,WOOLWORTHS/1473 ANZAC AVE - Visa Purchase - Receipt 170472In KALLANGUR Date 14 May 2021 Card 462263xxxxxx7746,,-36,7868.82,36
15/05/2021,Internal Transfer - Internal Transfer - Receipt 618149  0806227416,,-100,7904.82,100
13/05/2021,TRANSLINK - Visa Purchase - Receipt 157156In BRISBANE Date 11 May 2021 Card 462263xxxxxx7746,,-20,209.15,20
13/05/2021,Cotton On - Visa Purchase - Receipt 157155In Geelong Date 11 May 2021 Card 462263xxxxxx7495,,-30.98,229.15,30.98
13/05/2021,OXFAM AUSTRALIA Q - Visa Purchase - Receipt 157154In CARLTON Date 11 May 2021 Card 462263xxxxxx7746,,-55,260.13,55
12/05/2021,BRIGHT SHADOW TRADIN - Visa Purchase - Receipt 120982In GRIFFIN Date 08 May 2021 Card 462263xxxxxx7746,,-5.5,315.13,5.5
12/05/2021,BEECHAM HOLDEN & NIS - Visa Purchase - Receipt 120981In CABOOLTURE Date 10 May 2021 Card 462263xxxxxx7746,,-771,320.63,771
12/05/2021,LINKT BRISBANE - Visa Purchase - Receipt 120980In BRISBANE Date 09 May 2021 Card 462263xxxxxx7746,,-25.09,1091.63,25.09
10/05/2021,WOOLWORTHS/1473 ANZAC AVE - Visa Purchase - Receipt 146296In KALLANGUR Date 09 May 2021 Card 462263xxxxxx7746,,-30.69,45.72,30.69
8/05/2021,WOOLWORTHS/WATERFORD DRIV - Visa Purchase - Receipt 174922In NORTH LAKES Date 07 May 2021 Card 462263xxxxxx7746,,-44.64,76.41,44.64
8/05/2021,Ollie's Place - Visa Purchase - Receipt 174921In North Lakes Date 07 May 2021 Card 462263xxxxxx7746,,-113.95,121.05,113.95
8/05/2021,WU 2112688936215166 - Visa Purchase - Receipt 174920In 1800173833 Date 06 May 2021 Card 462263xxxxxx7746,,-60.86,235,60.86
8/05/2021,PAYPAL *LFKINDY - Visa Purchase - Receipt 174919In 4029357733 Date 06 May 2021 Card 462263xxxxxx7746,,-169.96,295.86,169.96
7/05/2021,COSTCO FUEL NORTH LAKE NORTH LAKES - EFTPOS Purchase - Receipt 86914Date 07 May 2021 Time 3:21PM Card 462263xxxxxx7746,,-70.39,465.82,70.39
7/05/2021,COSTCO FUEL NORTH LAKE NORTH LAKES - EFTPOS Purchase - Receipt 86912Date 07 May 2021 Time 3:21PM Card 462263xxxxxx7746,,-80,456.21,80
7/05/2021,Telstra Direct Debit - Visa Purchase - Receipt 110165In AUSTRALIA Date 05 May 2021 Card 462263xxxxxx7746,,-111.62,236.21,111.62
5/05/2021,MCDONALDS KALLANGUR - Visa Purchase - Receipt 148941In KALLANGUR Date 30 Apr 2021 Card 462263xxxxxx7746,,-7.95,347.83,7.95
4/05/2021,Adobe Systems Pty Ltd - Visa Purchase - Receipt 146246In Sydney Date 02 May 2021 Card 462263xxxxxx7746,,-14.29,355.78,14.29
4/05/2021,VALLEYGIRL NORTHALKES - Visa Purchase - Receipt 146245In NORTH LAKES Date 01 May 2021 Card 462263xxxxxx7746,,-25.99,370.07,25.99
3/05/2021,Raiz Maint Fee - Direct Debit - Receipt 142405 2152f5de5f0fc4f916,,-3.5,396.06,3.5
3/05/2021,ALDI STORES - KALLANGU - Visa Purchase - Receipt 143821In KALLANGUR Date 30 Apr 2021 Card 462263xxxxxx7746,,-25.75,399.56,25.75
2/05/2021,ALDI STORES - KALLANGU - Visa Purchase - Receipt 112726In KALLANGUR Date 29 Apr 2021 Card 462263xxxxxx7746,,-37.05,425.31,37.05
1/05/2021,MCDONALDS NORTH LAKES - Visa Purchase - Receipt 160373In NORTH LAKES Date 28 Apr 2021 Card 462263xxxxxx7746,,-4,462.36,4
1/05/2021,BONDS ONLINE - Visa Purchase - Receipt 160372In KEW Date 29 Apr 2021 Card 462263xxxxxx7495,,-32.38,466.36,32.38
1/05/2021,PAYPAL *LFKINDY - Visa Purchase - Receipt 160371In 4029357733 Date 29 Apr 2021 Card 462263xxxxxx7746,,-169.96,498.74,169.96
29/04/2021,Raiz Investment - Direct Debit - Receipt 167237 3b9441630a90841efe,,-20.21,668.7,20.21
29/04/2021,AMZNPRIMEAU MEMBERSHIP - Visa Purchase - Receipt 108642In SYDNEY SOUTH Date 28 Apr 2021 Card 462263xxxxxx7746,,-6.99,623.91,6.99
29/04/2021,UNITYWATER - CABOOLTUR - Visa Purchase - Receipt 108641In CABOOLTURE Date 27 Apr 2021 Card 462263xxxxxx7746,,-411.09,630.9,411.09
28/04/2021,KMART 1228 NORTH LAKES - EFTPOS Purchase - Receipt 166951Date 28 Apr 2021 Time 3:03PM Card 462263xxxxxx7746,,-43,1041.99,43
28/04/2021,IKEA NORTHLAKES NORTH LAKES - EFTPOS Purchase - Receipt 379337Date 28 Apr 2021 Time 2:07PM Card 462263xxxxxx7746,,-8,1084.99,8
28/04/2021,"H  M Hennes  Mauritz Pt - Visa Purchase - Receipt 129961In NSW, Sydney Date 26 Apr 2021 Card 462263xxxxxx7495",,-50.94,1092.99,50.94
28/04/2021,COSTCO FUEL NORTH LAKE - Visa Purchase - Receipt 129960In NORTH LAKES Date 26 Apr 2021 Card 462263xxxxxx7746,,-38.24,1143.93,38.24
27/04/2021,SMP*BLVD Bar Cafe - Visa Purchase - Receipt 100401In North Lakes Date 25 Apr 2021 Card 462263xxxxxx7746,,-58.45,732.17,58.45
26/04/2021,MICROSOFT*EA PLAY 1 MONTH - Visa Purchase - Receipt 187416In MSBILL.INFO Date 24 Apr 2021 Card 462263xxxxxx7746,,-6.99,790.62,6.99
25/04/2021,International Transaction Fee - Receipt 106133,,-1.86,795.75,1.86
25/04/2021,PatPat.com - Visa Purchase - Receipt 106133Foreign Currency Amount:  0In INTERNET Date 23 Apr 2021 Card 462263xxxxxx7746,,-74.46,797.61,74.46
25/04/2021,SP * MAMACLOTHING - Visa Purchase - Receipt 106132In POINT COOK Date 23 Apr 2021 Card 462263xxxxxx7495,,-19.95,872.07,19.95
25/04/2021,BIG W/1 NORTHLAKES DR - Visa Purchase - Receipt 106131In NORTHLAKES Date 24 Apr 2021 Card 462263xxxxxx7746,,-60,892.02,60
25/04/2021,WOOLWORTHS ONLINE 8843 - Visa Purchase - Receipt 106130In BELLA VISTA Date 23 Apr 2021 Card 462263xxxxxx7746,,-49.43,952.02,49.43
24/04/2021,Audible Australia - Visa Purchase - Receipt 179979In MELBOURNE Date 22 Apr 2021 Card 462263xxxxxx7746,,-16.45,801.45,16.45
24/04/2021,PAYPAL *LFKINDY - Visa Purchase - Receipt 179978In 4029357733 Date 22 Apr 2021 Card 462263xxxxxx7746,,-169.96,817.9,169.96
24/04/2021,PAYPAL *TATTSONLINE - Visa Purchase - Receipt 179977In 4029357733 Date 22 Apr 2021 Card 462263xxxxxx7746,,-54.3,987.86,54.3
23/04/2021,INDIAN SPICE SHOP      AS PLEY       Q - EFTPOS Purchase - Receipt 3074Date 23 Apr 2021 Time 2:57PM Card 462263xxxxxx7746,,-94.02,1042.16,94.02
23/04/2021,LIVING FAITH LTHRN PS - Visa Purchase - Receipt 108728In MILTON Date 20 Apr 2021 Card 462263xxxxxx7746,,-300,1136.18,300
22/04/2021,ASHAPURI PTY LTD - Visa Purchase - Receipt 164666In GRIFFIN Date 20 Apr 2021 Card 462263xxxxxx7746,,-22.4,1436.18,22.4
22/04/2021,MSFT *<E0400E2HY3> - Visa Purchase - Receipt 164665In MSFT AZURE Date 20 Apr 2021 Card 462263xxxxxx7746,,-3.22,1458.58,3.22
21/04/2021,TRANSLINK - Visa Purchase - Receipt 155945In BRISBANE Date 19 Apr 2021 Card 462263xxxxxx7746,,-20,1461.8,20
21/04/2021,ALDI STORES - NORTH LA - Visa Purchase - Receipt 155944In NORTH LAKES Date 18 Apr 2021 Card 462263xxxxxx7746,,-56.13,1481.8,56.13
20/04/2021,Raiz Investment - Direct Debit - Receipt 113200 cd1427d907db04bb3b,,-26.63,1537.93,26.63
20/04/2021,International Transaction Fee - Receipt 176858,,-0.91,1563.65,0.91
20/04/2021,GoFndMe* Help Christa com - Visa Purchase - Receipt 176858Foreign Currency Amount: USD 28.13In Redwood City Date 18 Apr 2021 Card 462263xxxxxx7495,,-36.43,1564.56,36.43
20/04/2021,SP * PEACHYMAMA - Visa Purchase - Receipt 176857In ELWOOD Date 18 Apr 2021 Card 462263xxxxxx7495,,-59,1600.99,59
20/04/2021,NETFLIX.COM - Visa Purchase - Receipt 176856In Melbourne Date 18 Apr 2021 Card 462263xxxxxx7746,,-15.99,1659.99,15.99
20/04/2021,CALAMARI FROM SQUID - Visa Purchase - Receipt 176855In SCARBOROUGH Date 18 Apr 2021 Card 462263xxxxxx7746,,-96.03,1675.98,96.03
19/04/2021,LEASE PAY - Direct Debit - Receipt 104571 001-1347737-001,,-861,1772.01,861
19/04/2021,International Transaction Fee - Receipt 190670,,-0.67,2632.34,0.67
19/04/2021,DNH*GODADDY.COM AUSTRALIA - Visa Purchase - Receipt 190670Foreign Currency Amount:  0In 480-5058855 Date 17 Apr 2021 Card 462263xxxxxx7746,,-26.62,2633.01,26.62
19/04/2021,BWS 2482 - Visa Purchase - Receipt 190669In GRIFFIN Date 17 Apr 2021 Card 462263xxxxxx7746,,-69,2659.63,69
19/04/2021,WU 2110780185780024 - Visa Purchase - Receipt 190668In 1800173833 Date 17 Apr 2021 Card 462263xxxxxx7746,,-302.9,2728.63,302.9
19/04/2021,PAYPAL *MEDELAAUSTR - Visa Purchase - Receipt 190667In 4029357733 Date 17 Apr 2021 Card 462263xxxxxx7746,,-48.4,3031.53,48.4
19/04/2021,UBER   *EATS - Visa Purchase - Receipt 190666In SYDNEY Date 17 Apr 2021 Card 462263xxxxxx7746,,-61.79,3079.93,61.79
18/04/2021,COLES 4545 NORTH LAKE - EFTPOS Purchase - Receipt 489256Date 18 Apr 2021 Time 4:24PM Card 462263xxxxxx7746,,-56.53,3141.72,56.53
18/04/2021,JB HOME NORTH LAKES NORTH LAKES - EFTPOS Purchase - Receipt 66856Date 18 Apr 2021 Time 3:57PM Card 462263xxxxxx7746,,-279,3198.25,279
18/04/2021,SQ *GATEAU & CO        Sc arborough - EFTPOS Purchase - Receipt 832079Date 18 Apr 2021 Time 10:43AM Card 462263xxxxxx7746,,-10,3477.25,10
18/04/2021,TRRYWHT CHM MURRUMB - Visa Purchase - Receipt 160554In MURRUMBA DOW Date 15 Apr 2021 Card 462263xxxxxx7746,,-27.15,3487.25,27.15
18/04/2021,MCDONALDS NORTH LAKES - Visa Purchase - Receipt 160553In NORTH LAKES Date 15 Apr 2021 Card 462263xxxxxx7746,,-28.25,3514.4,28.25
18/04/2021,Microsoft*Microsoft 365 P - Visa Purchase - Receipt 160552In msbill.info Date 16 Apr 2021 Card 462263xxxxxx7746,,-10,3542.65,10
18/04/2021,SQ *BLK BOX CO.        Gr iffin - EFTPOS Purchase - Receipt 291140Date 18 Apr 2021 Time 8:28AM Card 462263xxxxxx7746,,-12,3552.65,12
17/04/2021,BRIGHT SHADOW TRADIN   GR IFFIN      Q - EFTPOS Purchase - Receipt 71133Date 17 Apr 2021 Time 3:01PM Card 462263xxxxxx7746,,-1,3564.65,1
17/04/2021,PAYPAL *WENCHEN EBAY W - Visa Purchase - Receipt 121205In 4029357733 Date 15 Apr 2021 Card 462263xxxxxx7746,,-60.02,3565.65,60.02
17/04/2021,PAYPAL *LFKINDY - Visa Purchase - Receipt 121204In 4029357733 Date 15 Apr 2021 Card 462263xxxxxx7746,,-72.41,3625.67,72.41
17/04/2021,AGL SALES PTY LTD - Visa Purchase - Receipt 121203In SYDNEY Date 14 Apr 2021 Card 462263xxxxxx7746,,-127.97,3698.08,127.97
17/04/2021,MCDONALDS NORTH LAKES - Visa Purchase - Receipt 121202In NORTH LAKES Date 14 Apr 2021 Card 462263xxxxxx7746,,-2,3826.05,2
17/04/2021,COSTCO FUEL NORTH LAKE - Visa Purchase - Receipt 121201In NORTH LAKES Date 15 Apr 2021 Card 462263xxxxxx7746,,-76.75,3828.05,76.75
17/04/2021,WOOLWORTHS ONLINE 8843 - Visa Purchase - Receipt 121200In BELLA VISTA Date 15 Apr 2021 Card 462263xxxxxx7746,,-61.52,3904.8,61.52
17/04/2021,All Direct debits - Transfer to Kiran Joy - Receipt 143108 To 032885 5310008,,-3100,3966.32,3100
16/04/2021,Internal Transfer - Internal Transfer - Receipt 857522 Orange Everyday 0065083812,,-345,7066.32,345
16/04/2021,Internal Transfer - Internal Transfer - Receipt 777638 Savings Maximiser 0046211237,,-690,7411.32,690
16/04/2021,Internal Transfer - Internal Transfer - Receipt 777296 Savings Maximiser 0046211453,,-1180,8101.32,1180
16/04/2021,SP * LITTLEBABYPAWS - Visa Purchase - Receipt 157589In MELBOURNE Date 15 Apr 2021 Card 462263xxxxxx7495,,-34.41,9281.32,34.41
16/04/2021,TRANSLINK - Visa Purchase - Receipt 157588In BRISBANE Date 14 Apr 2021 Card 462263xxxxxx7746,,-20,9315.73,20
15/04/2021,Internal Transfer - Internal Transfer - Receipt 625507  0806227416,,-100,9335.73,100
15/04/2021,DISNEY PLUS - Visa Purchase - Receipt 175148In RICHMOND Date 13 Apr 2021 Card 462263xxxxxx7746,,-8.99,9435.73,8.99
14/04/2021,NORTH PINE SOCCER CL - Visa Purchase - Receipt 144455In DAKABIN Date 09 Apr 2021 Card 462263xxxxxx7746,,-4,324.05,4
14/04/2021,OXFAM AUSTRALIA Q - Visa Purchase - Receipt 144454In CARLTON Date 12 Apr 2021 Card 462263xxxxxx7746,,-55,328.05,55
14/04/2021,MCDONALDS KALLANGUR - Visa Purchase - Receipt 144453In KALLANGUR Date 09 Apr 2021 Card 462263xxxxxx7746,,-8.95,383.05,8.95
14/04/2021,TRANSPORTMAINRDS - Visa Purchase - Receipt 144452In BRISBANE Date 12 Apr 2021 Card 462263xxxxxx7746,,-378.96,392,378.96
13/04/2021,SHAPLAND SWIM KALLAN - Visa Purchase - Receipt 171702In KALLANGUR Date 12 Apr 2021 Card 462263xxxxxx7746,,-61.5,770.96,61.5
11/04/2021,Kogan MoneyBlackCard          4813635950084279 - BPAY Bill Payment - Receipt 458352 To Kogan MoneyBlackCard 4813635950084279,,-220,404.66,220
11/04/2021,Lawnton CM Bakery - Visa Purchase - Receipt 195970In Lawnton Date 10 Apr 2021 Card 462263xxxxxx7746,,-3.93,224.66,3.93
11/04/2021,ALDI STORES - KALLANGU - Visa Purchase - Receipt 195969In KALLANGUR Date 08 Apr 2021 Card 462263xxxxxx7746,,-39.71,228.59,39.71
10/04/2021,Telstra Direct Debit - Visa Purchase - Receipt 178470In AUSTRALIA Date 08 Apr 2021 Card 462263xxxxxx7746,,-111.62,268.3,111.62
9/04/2021,Raiz Investment - Direct Debit - Receipt 151614 88d50d597b42650290,,-22.34,379.92,22.34
9/04/2021,PLINE PH WESTFIELD NL  NO RTH LAKES  Q - EFTPOS Purchase - Receipt 24688Date 09 Apr 2021 Time 3:30PM Card 462263xxxxxx7746,,-27.67,402.26,27.67
9/04/2021,BeachHouse NorthLakes - Visa Purchase - Receipt 174129In Mango Hill Date 08 Apr 2021 Card 462263xxxxxx7746,,-49.43,429.93,49.43
9/04/2021,BeachHouse NorthLakes - Visa Purchase - Receipt 174128In Mango Hill Date 08 Apr 2021 Card 462263xxxxxx7746,,-16.21,479.36,16.21
8/04/2021,Goodstart Murrum - Direct Debit - Receipt 155764 A006N61R13FA,,-300,495.57,300
8/04/2021,Transfer to Kiran Joy - Receipt 881287 To 032885 5310008 - Transfer to Kiran Joy - Receipt 881287 To 032885 5310008,,-4000,795.57,4000
8/04/2021,PAYPAL *COLESSUPERM EB - Visa Purchase - Receipt 112334In 4029357733 Date 06 Apr 2021 Card 462263xxxxxx7746,,-56.6,295.57,56.6
8/04/2021,JAY MEDICALS PTY LTD - Visa Purchase - Receipt 112333In GRIFFIN Date 06 Apr 2021 Card 462263xxxxxx7495,,-110,352.17,110
7/04/2021,International Transaction Fee - Receipt 123907,,-0.93,461.24,0.93
7/04/2021,Banggood.com - Visa Purchase - Receipt 123907Foreign Currency Amount:  0In HongKong Date 06 Apr 2021 Card 462263xxxxxx7746,,-37.35,462.17,37.35
6/04/2021,Raiz Maint Fee - Direct Debit - Receipt 149917 c1b1a28ae5320fa494,,-3.5,412.07,3.5
6/04/2021,WOOLWORTHS 2752 - Visa Purchase - Receipt 112434In KALLANGUR Date 04 Apr 2021 Card 462263xxxxxx7746,,-10.5,415.57,10.5
6/04/2021,WOOLWORTHS 2508 - Visa Purchase - Receipt 112433In MANGO HILL Date 04 Apr 2021 Card 462263xxxxxx7746,,-43.7,426.07,43.7
5/04/2021,International Transaction Fee - Receipt 159545,,-0.36,469.41,0.36
5/04/2021,ADOBE PHOTOGPHY PLAN - Visa Purchase - Receipt 159545Foreign Currency Amount:  0In ADOBE.LY/ENA Date 03 Apr 2021 Card 462263xxxxxx7746,,-14.29,469.77,14.29
5/04/2021,WOOLWORTHS 2752 - Visa Purchase - Receipt 159544In KALLANGUR Date 03 Apr 2021 Card 462263xxxxxx7746,,-55,484.06,55
3/04/2021,BIG W ONLINE 0800 - Visa Purchase - Receipt 168432In BELLA VISTA Date 01 Apr 2021 Card 462263xxxxxx7495,,-73,539.06,73
3/04/2021,WOOLWORTHS ONLINE 8843 - Visa Purchase - Receipt 168431In BELLA VISTA Date 01 Apr 2021 Card 462263xxxxxx7746,,-50.2,612.06,50.2
3/04/2021,WOOLWORTHS 2752 - Visa Purchase - Receipt 168430In KALLANGUR Date 01 Apr 2021 Card 462263xxxxxx7746,,-14.74,662.26,14.74
2/04/2021,Dominos Estore Murrumba D - Visa Purchase - Receipt 142911In dominos.com. Date 31 Mar 2021 Card 462263xxxxxx7495,,-23,677,23
31/03/2021,TRANSLINK - Visa Purchase - Receipt 140415In BRISBANE Date 29 Mar 2021 Card 462263xxxxxx7746,,-20,656,20
29/03/2021,Raiz Investment - Direct Debit - Receipt 135591 b47c1c22ac59ddd29f,,-20.28,676,20.28
29/03/2021,AMZNPRIMEAU MEMBERSHIP - Visa Purchase - Receipt 193699In SYDNEY SOUTH Date 28 Mar 2021 Card 462263xxxxxx7746,,-6.99,696.28,6.99
28/03/2021,BIG W/1 NORTHLAKES DR - Visa Purchase - Receipt 122454In NORTHLAKES Date 27 Mar 2021 Card 462263xxxxxx7746,,-30.99,703.27,30.99
28/03/2021,MCDONALDS MURRUMBA DO - Visa Purchase - Receipt 122453In MURRUMBA DOW Date 25 Mar 2021 Card 462263xxxxxx7495,,-22.9,734.26,22.9
26/03/2021,COLES 4545 NORTH LAKE - EFTPOS Purchase - Receipt 330404Date 26 Mar 2021 Time 5:46PM Card 462263xxxxxx7746,,-0.72,757.16,0.72
26/03/2021,SQ *BROW N LASH EXPRES Mu rrumba Down - EFTPOS Purchase - Receipt 436257Date 26 Mar 2021 Time 5:12PM Card 462263xxxxxx7495,,-15.3,757.88,15.3
26/03/2021,Microsoft*EA Play 1 Month - Visa Purchase - Receipt 189448In msbill.info Date 24 Mar 2021 Card 462263xxxxxx7746,,-6.99,773.18,6.99
25/03/2021,WOOLWORTHS      2752   KA LLANGUR QLD - EFTPOS Purchase - Receipt 340180Date 25 Mar 2021 Time 6:36PM Card 462263xxxxxx7746,,-23.8,780.17,23.8
25/03/2021,SQ *TANZ GARAGE HAIR S Gr iffin - EFTPOS Purchase - Receipt 888569Date 25 Mar 2021 Time 3:22PM Card 462263xxxxxx7495,,-52,803.97,52
24/03/2021,Audible Australia - Visa Purchase - Receipt 102870In MELBOURNE Date 22 Mar 2021 Card 462263xxxxxx7746,,-16.45,855.97,16.45
23/03/2021,David Ree Shanoo gift from Kiran - Osko Payment to 084069 171478957 - Receipt 473314 ,,-30,872.42,30
21/03/2021,WOOLWORTHS 2752 - Visa Purchase - Receipt 115013In KALLANGUR Date 19 Mar 2021 Card 462263xxxxxx7746,,-33,902.42,33
21/03/2021,MSFT *<E0400DR8W4> - Visa Purchase - Receipt 115012In MSFT AZURE Date 19 Mar 2021 Card 462263xxxxxx7746,,-6.03,935.42,6.03
21/03/2021,NETFLIX COM - Visa Purchase - Receipt 115011In MELBOURNE Date 19 Mar 2021 Card 462263xxxxxx7746,,-15.99,941.45,15.99
19/03/2021,WOOLWORTHS 2752 - Visa Purchase - Receipt 170654In KALLANGUR Date 14 Mar 2021 Card 462263xxxxxx7746,,-18.65,892.44,18.65
18/03/2021,Raiz Investment - Direct Debit - Receipt 169598 63a1e5399a76c73eb2,,-22.53,911.09,22.53
18/03/2021,MICROSOFT*MICROSOFT 365 P - Visa Purchase - Receipt 149152In MSBILL.INFO Date 16 Mar 2021 Card 462263xxxxxx7746,,-10,933.62,10
17/03/2021,LEASE PAY - Direct Debit - Receipt 118010 001-1347737-001,,-761,943.62,761
17/03/2021,All Direct debits - Transfer to Kiran Joy - Receipt 509321 To 032885 5310008,,-3100,1704.62,3100
17/03/2021,7-ELEVEN 4062 - Visa Purchase - Receipt 137792In BRISBANE Date 15 Mar 2021 Card 462263xxxxxx7746,,-7,4804.62,7
17/03/2021,7 ELEVEN 4228 - Visa Purchase - Receipt 137791In KALLANGUR Date 14 Mar 2021 Card 462263xxxxxx7746,,-20.55,4811.62,20.55
17/03/2021,ALDI STORES - KALLANGU - Visa Purchase - Receipt 137790In KALLANGUR Date 14 Mar 2021 Card 462263xxxxxx7746,,-108.39,4832.17,108.39
17/03/2021,TRANSLINK - Visa Purchase - Receipt 137789In BRISBANE Date 15 Mar 2021 Card 462263xxxxxx7746,,-20,4940.56,20
17/03/2021,SPENDLESS SHOES - Visa Purchase - Receipt 137788In MANGO HILL Date 14 Mar 2021 Card 462263xxxxxx7746,,-54.98,4960.56,54.98
16/03/2021,Internal Transfer - Internal Transfer - Receipt 359488 Orange Everyday 0065083812,,-345,5015.54,345
16/03/2021,Internal Transfer - Internal Transfer - Receipt 216296 Savings Maximiser 0046211453,,-1180,5360.54,1180
16/03/2021,Internal Transfer - Internal Transfer - Receipt 216127 Savings Maximiser 0046211237,,-690,6540.54,690
15/03/2021,BWS 2482 - Visa Purchase - Receipt 103649In GRIFFIN Date 13 Mar 2021 Card 462263xxxxxx7746,,-39,7230.54,39
15/03/2021,WOOLWORTHS ONLINE 8843 - Visa Purchase - Receipt 103648In BELLA VISTA Date 13 Mar 2021 Card 462263xxxxxx7746,,-39.53,7269.54,39.53
15/03/2021,DISNEY PLUS - Visa Purchase - Receipt 103647In RICHMOND Date 13 Mar 2021 Card 462263xxxxxx7746,,-8.99,7309.07,8.99
15/03/2021,AUSSIE SEAFOOD HOUSE - Visa Purchase - Receipt 103646In LAWNTON Date 13 Mar 2021 Card 462263xxxxxx7746,,-13.37,7318.06,13.37
14/03/2021,MITHUN MOHAN Airbnb kiran - Osko Payment to +61-403642318 - Receipt 468281 ,,-392.8,7331.43,392.8
14/03/2021,Hungry Jacks Kallangur - EFTPOS Purchase - Receipt 364288Date 14 Mar 2021 Time 12:44PM Card 462263xxxxxx7746,,-30.95,7724.23,30.95
14/03/2021,SURPRISEBRO  PTY LTD - Visa Purchase - Receipt 103207In NORTH LAKES Date 11 Mar 2021 Card 462263xxxxxx7746,,-12.9,7755.18,12.9
14/03/2021,BRIGHT SHADOW TRADIN - Visa Purchase - Receipt 103206In GRIFFIN Date 12 Mar 2021 Card 462263xxxxxx7495,,-5,7768.08,5
14/03/2021,Lawnton CM Bakery - Visa Purchase - Receipt 103205In Lawnton Date 13 Mar 2021 Card 462263xxxxxx7746,,-3.53,7773.08,3.53
14/03/2021,Warburton Butcher LT - Visa Purchase - Receipt 103204In Lawnton Date 13 Mar 2021 Card 462263xxxxxx7746,,-32.46,7776.61,32.46
14/03/2021,Lawnton Country Marke - Visa Purchase - Receipt 103203In Lawnton Date 13 Mar 2021 Card 462263xxxxxx7746,,-40.21,7809.07,40.21
13/03/2021,Internal Transfer - Internal Transfer - Receipt 61936  0806227416,,-100,7849.28,100
13/03/2021,AMAZON MKTPLC AU - Visa Purchase - Receipt 141380In SYDNEY SOUTH Date 11 Mar 2021 Card 462263xxxxxx7746,,-7.99,7940.78,7.99
13/03/2021,CHEMIST WAREHOUSE - Visa Purchase - Receipt 141379In NORTH LAKES Date 11 Mar 2021 Card 462263xxxxxx7746,,-29.97,7948.77,29.97
13/03/2021,SHAPLAND SWIM KALLAN - Visa Purchase - Receipt 141378In KALLANGUR Date 11 Mar 2021 Card 462263xxxxxx7746,,-82,7978.74,82
13/03/2021,SURPRISEBRO PTY. LTD - Visa Purchase - Receipt 141377In NORTH LAKES Date 11 Mar 2021 Card 462263xxxxxx7746,,-0.2,8060.74,0.2
13/03/2021,BEST AND LESS - Visa Purchase - Receipt 141376In MANGO HILL Date 11 Mar 2021 Card 462263xxxxxx7746,,-58,8060.94,58
13/03/2021,QATT DEVELOPMENT PTY L - Visa Purchase - Receipt 141375In NORTH LAKES Date 11 Mar 2021 Card 462263xxxxxx7746,,-9.5,8118.94,9.5
13/03/2021,REBEL BRISBANE - Visa Purchase - Receipt 141374In BRISBANE Date 10 Mar 2021 Card 462263xxxxxx7746,,-49.99,8128.44,49.99
12/03/2021,OXFAM AUSTRALIA Q - Visa Purchase - Receipt 178084In CARLTON Date 10 Mar 2021 Card 462263xxxxxx7746,,-55,277.76,55
12/03/2021,TARGET 5167 - Visa Purchase - Receipt 178083In NORTH LAKES Date 11 Mar 2021 Card 462263xxxxxx7746,,-61,332.76,61
11/03/2021,International Transaction Fee - Receipt 153529,,-1.94,276.82,1.94
11/03/2021,SP * GIFTBOX BOUTIQUE - Visa Purchase - Receipt 153529Foreign Currency Amount: NZD 82.99In WHANGAREI Date 09 Mar 2021 Card 462263xxxxxx7495,,-77.4,278.76,77.4
11/03/2021,AMAZON AU - Visa Purchase - Receipt 153528In SYDNEY SOUTH Date 08 Mar 2021 Card 462263xxxxxx7746,,-11.99,356.16,11.99
10/03/2021,Raiz Investment - Direct Debit - Receipt 109758 e6f1b761b425714045,,-22.69,368.15,22.69
10/03/2021,SP * TOY UNIVERSE - Visa Purchase - Receipt 135345In FREMANTLE Date 08 Mar 2021 Card 462263xxxxxx7495,,-34.65,390.84,34.65
10/03/2021,IKEA NORTHLAKES - Visa Purchase - Receipt 135344In NORTH LAKES Date 08 Mar 2021 Card 462263xxxxxx7746,,-65.48,425.49,65.48
10/03/2021,WOOLWORTHS ONLINE 8843 - Visa Purchase - Receipt 135343In BELLA VISTA Date 08 Mar 2021 Card 462263xxxxxx7746,,-33.97,490.97,33.97
10/03/2021,Telstra Direct Debit - Visa Purchase - Receipt 135342In AUSTRALIA Date 08 Mar 2021 Card 462263xxxxxx7746,,-111.62,524.94,111.62
9/03/2021,SP * YELLOW OCTOPUS - Visa Purchase - Receipt 182113In MOORABBIN Date 08 Mar 2021 Card 462263xxxxxx7495,,-33.98,336.56,33.98
9/03/2021,COTTON ON KIDS 4223 - Visa Purchase - Receipt 182112In MANGO HILL Date 07 Mar 2021 Card 462263xxxxxx7495,,-18.49,370.54,18.49
9/03/2021,WOOLWORTHS 2508 - Visa Purchase - Receipt 182111In MANGO HILL Date 07 Mar 2021 Card 462263xxxxxx7746,,-27.67,389.03,27.67
8/03/2021,IKEA NORTHLAKES NORTH LAKES - EFTPOS Purchase - Receipt 366040Date 08 Mar 2021 Time 4:59PM Card 462263xxxxxx7746,,-3,416.7,3
7/03/2021,WOOLWORTHS 2508 - Visa Purchase - Receipt 101937In MANGO HILL Date 05 Mar 2021 Card 462263xxxxxx7746,,-3.3,89.7,3.3
7/03/2021,ALDI STORES - KALLANGU - Visa Purchase - Receipt 101936In KALLANGUR Date 04 Mar 2021 Card 462263xxxxxx7495,,-40.7,93,40.7
6/03/2021,TRANSLINK - Visa Purchase - Receipt 156635In BRISBANE Date 03 Mar 2021 Card 462263xxxxxx7746,,-20,133.7,20
5/03/2021,International Transaction Fee - Receipt 112811,,-0.36,153.34,0.36
5/03/2021,ADOBE PHOTOGPHY PLAN - Visa Purchase - Receipt 112811Foreign Currency Amount:  0In ADOBE.LY/ENA Date 03 Mar 2021 Card 462263xxxxxx7746,,-14.29,153.7,14.29
4/03/2021,WOOLWORTHS 2752 - Visa Purchase - Receipt 174801In KALLANGUR Date 02 Mar 2021 Card 462263xxxxxx7746,,-41.83,167.99,41.83
3/03/2021,International Transaction Fee - Receipt 138535,,-0.87,208.95,0.87
3/03/2021,JLCPCB.COM - Visa Purchase - Receipt 138535Foreign Currency Amount: USD 26.9In MONG KOK Date 02 Mar 2021 Card 462263xxxxxx7746,,-34.96,209.82,34.96
2/03/2021,CHEMIST WAREHOUSE - Visa Purchase - Receipt 163080In NORTH LAKES Date 28 Feb 2021 Card 462263xxxxxx7746,,-9.08,244.78,9.08
1/03/2021,Raiz Maint Fee - Direct Debit - Receipt 192361 280a5c3975867c5def,,-2.5,253.86,2.5
1/03/2021,International Transaction Fee - Receipt 194007,,-1.26,255.1,1.26
1/03/2021,PatPat.com - Visa Purchase - Receipt 194007Foreign Currency Amount:  0In INTERNET Date 27 Feb 2021 Card 462263xxxxxx7746,,-50.56,256.36,50.56
1/03/2021,AMZNPRIMEAU MEMBERSHIP - Visa Purchase - Receipt 194006In SYDNEY SOUTH Date 28 Feb 2021 Card 462263xxxxxx7746,,-6.99,306.92,6.99
1/03/2021,ALDI STORES - NORTH LA - Visa Purchase - Receipt 194005In NORTH LAKES Date 26 Feb 2021 Card 462263xxxxxx7746,,-102.14,313.91,102.14
28/02/2021,COLES 4545 NORTH LAKE - EFTPOS Purchase - Receipt 34289Date 28 Feb 2021 Time 3:40PM Card 462263xxxxxx7746,,-35.55,416.05,35.55
28/02/2021,Lawnton Country Marke - Visa Purchase - Receipt 191119In Lawnton Date 27 Feb 2021 Card 462263xxxxxx7746,,-45.03,451.6,45.03
28/02/2021,WU *2768654580 - Visa Purchase - Receipt 191118In SYDNEY Date 26 Feb 2021 Card 462263xxxxxx7746,,-882.9,496.63,882.9
27/02/2021,TRANSLINK - Visa Purchase - Receipt 178076In BRISBANE Date 24 Feb 2021 Card 462263xxxxxx7746,,-20,1379.53,20
27/02/2021,PAYPAL *LFKINDY - Visa Purchase - Receipt 178075In 4029357733 Date 25 Feb 2021 Card 462263xxxxxx7746,,-1117.31,1399.53,1117.31
26/02/2021,Raiz Investment - Direct Debit - Receipt 125456 7c8f6fcda8bfc91021,,-21.57,2516.84,21.57
26/02/2021,Microsoft*EA Play 1 Month - Visa Purchase - Receipt 177009In msbill.info Date 24 Feb 2021 Card 462263xxxxxx7746,,-6.99,1538.41,6.99
25/02/2021,LIVING FAITH LUTHERA - Visa Purchase - Receipt 139303In MURRUMBA DOW Date 23 Feb 2021 Card 462263xxxxxx7746,,-1117.31,1545.4,1117.31
25/02/2021,COSTCO WHOLESALE AUS - Visa Purchase - Receipt 139302In NORTH LAKES Date 23 Feb 2021 Card 462263xxxxxx7746,,-131.43,2662.71,131.43
25/02/2021,COSTCO FUEL NORTH LAKE - Visa Purchase - Receipt 139301In NORTH LAKES Date 23 Feb 2021 Card 462263xxxxxx7746,,-51.53,2794.14,51.53
25/02/2021,JAY MEDICALS PTY LTD - Visa Purchase - Receipt 139300In GRIFFIN Date 23 Feb 2021 Card 462263xxxxxx7495,,-110,2845.67,110
24/02/2021,UBER   *EATS - Visa Purchase - Receipt 116069In SYDNEY Date 22 Feb 2021 Card 462263xxxxxx7495,,-34,2955.67,34
24/02/2021,Audible Australia - Visa Purchase - Receipt 116068In MELBOURNE Date 22 Feb 2021 Card 462263xxxxxx7746,,-16.45,2989.67,16.45
23/02/2021,Fortify Physio INV007425 - Kiran Joy - Osko Payment to 064110 10375179 - Receipt 61020  - Ref INV007425 - Kiran Joy,,-58,2918.67,58
23/02/2021,MEATLAND - Visa Purchase - Receipt 116322In NORTH LAKES Date 22 Feb 2021 Card 462263xxxxxx7746,,-58.14,2976.67,58.14
23/02/2021,METRO NORTH HOSPITAL A - Visa Purchase - Receipt 116321In HERSTON Date 21 Feb 2021 Card 462263xxxxxx7746,,-11,3034.81,11
22/02/2021,INDIAN SPICE SHOP      AS PLEY       Q - EFTPOS Purchase - Receipt 49400Date 22 Feb 2021 Time 7:24PM Card 462263xxxxxx7746,,-134.76,3045.81,134.76
22/02/2021,KMART 1228 - Visa Purchase - Receipt 118039In NORTH LAKES Date 21 Feb 2021 Card 462263xxxxxx7746,,-7,3180.57,7
22/02/2021,ALDI STORES - KALLANGU - Visa Purchase - Receipt 118038In KALLANGUR Date 19 Feb 2021 Card 462263xxxxxx7746,,-86.95,3187.57,86.95
21/02/2021,NETFLIX COM - Visa Purchase - Receipt 116006In MELBOURNE Date 19 Feb 2021 Card 462263xxxxxx7746,,-15.99,3239.09,15.99
21/02/2021,BWS LIQUOUR 2385 - Visa Purchase - Receipt 116005In KALLANGUR Date 19 Feb 2021 Card 462263xxxxxx7746,,-20,3255.08,20
21/02/2021,WOOLWORTHS ONLINE 8843 - Visa Purchase - Receipt 116004In BELLA VISTA Date 19 Feb 2021 Card 462263xxxxxx7746,,-50.08,3275.08,50.08
21/02/2021,WOOLWORTHS ONLINE 8843 - Visa Purchase - Receipt 116003In BELLA VISTA Date 19 Feb 2021 Card 462263xxxxxx7746,,-48.43,3325.16,48.43
21/02/2021,ALDI STORES - KALLANGU - Visa Purchase - Receipt 116002In KALLANGUR Date 18 Feb 2021 Card 462263xxxxxx7746,,-22.58,3373.59,22.58
21/02/2021,MSFT *<E0400DG9FJ> - Visa Purchase - Receipt 116001In MSFT AZURE Date 19 Feb 2021 Card 462263xxxxxx7746,,-3.8,3396.17,3.8
19/02/2021,WU 2104882841653044 - Visa Purchase - Receipt 157955In 1800173833 Date 17 Feb 2021 Card 462263xxxxxx7746,,-302.9,3334.97,302.9
19/02/2021,PAYPAL *NINGSUPEIDI EB - Visa Purchase - Receipt 157954In 4029357733 Date 17 Feb 2021 Card 462263xxxxxx7746,,-35.92,3637.87,35.92
18/02/2021,TRANSLINK - Visa Purchase - Receipt 108076In BRISBANE Date 15 Feb 2021 Card 462263xxxxxx7746,,-20,3673.79,20
18/02/2021,MICROSOFT*MICROSOFT 365 P - Visa Purchase - Receipt 108075In MSBILL.INFO Date 16 Feb 2021 Card 462263xxxxxx7746,,-10,3693.79,10
17/02/2021,LEASE PAY - Direct Debit - Receipt 116766 001-1347737-001,,-761,3703.79,761
17/02/2021,Raiz Investment - Direct Debit - Receipt 109680 eb3881fbb995c1c1d1,,-20.1,4464.79,20.1
17/02/2021,All Direct debits - Transfer to Kiran Joy - Receipt 331972 To 032885 5310008,,-3100,4484.89,3100
17/02/2021,CHEMIST WAREHOUSE - Visa Purchase - Receipt 167102In MANGO HILL Date 15 Feb 2021 Card 462263xxxxxx7746,,-6.99,7584.89,6.99
17/02/2021,WU *7889093673 - Visa Purchase - Receipt 167101In SYDNEY Date 15 Feb 2021 Card 462263xxxxxx7746,,-122.9,7591.88,122.9
16/02/2021,AZMAN HAROON - Visa Purchase - Receipt 155514In NORTH LAKES Date 12 Feb 2021 Card 462263xxxxxx7495,,-87.04,7714.78,87.04
16/02/2021,BWS LIQUOUR 2385 - Visa Purchase - Receipt 155513In KALLANGUR Date 14 Feb 2021 Card 462263xxxxxx7746,,-12,7801.82,12
16/02/2021,WOOLWORTHS 2752 - Visa Purchase - Receipt 155512In KALLANGUR Date 14 Feb 2021 Card 462263xxxxxx7746,,-62.71,7813.82,62.71
16/02/2021,Internal Transfer - Internal Transfer - Receipt 352414 Savings Maximiser 0046211453,,-1180,7876.53,1180
16/02/2021,Internal Transfer - Internal Transfer - Receipt 352238 Savings Maximiser 0046211237,,-690,9056.53,690
16/02/2021,Internal Transfer - Internal Transfer - Receipt 295278 Orange Everyday 0065083812,,-345,9746.53,345
15/02/2021,Internal Transfer - Internal Transfer - Receipt 661408  0806227416,,-100,10091.53,100
15/02/2021,DISNEY PLUS - Visa Purchase - Receipt 179938In RICHMOND Date 13 Feb 2021 Card 462263xxxxxx7746,,-8.99,10191.53,8.99
13/02/2021,GOURMET MEATS - Visa Purchase - Receipt 122763In MURRUMBA DOW Date 12 Feb 2021 Card 462263xxxxxx7746,,-17.53,10200.52,17.53
13/02/2021,UBER   *EATS - Visa Purchase - Receipt 122762In SYDNEY Date 11 Feb 2021 Card 462263xxxxxx7495,,-34.8,10218.05,34.8
13/02/2021,ALDI STORES - NORTH LA - Visa Purchase - Receipt 122761In NORTH LAKES Date 10 Feb 2021 Card 462263xxxxxx7746,,-32.49,10252.85,32.49
13/02/2021,Vodafone Australia - Visa Purchase - Receipt 122760In North Sydney Date 10 Feb 2021 Card 462263xxxxxx7746,,-69.59,10285.34,69.59
12/02/2021,OXFAM AUSTRALIA Q - Visa Purchase - Receipt 165289In CARLTON Date 10 Feb 2021 Card 462263xxxxxx7746,,-55,2885.6,55
12/02/2021,COSTCO FUEL NORTH LAKE - Visa Purchase - Receipt 165288In NORTH LAKES Date 10 Feb 2021 Card 462263xxxxxx7746,,-54.98,2940.6,54.98
12/02/2021,7-ELEVEN 4266 - Visa Purchase - Receipt 165287In GRIFFIN Date 09 Feb 2021 Card 462263xxxxxx7746,,-20.39,2995.58,20.39
11/02/2021,SHAPLAND SWIM KALLAN - Visa Purchase - Receipt 130601In KALLANGUR Date 10 Feb 2021 Card 462263xxxxxx7746,,-61.5,3015.97,61.5
11/02/2021,THE RUSTIC OLIVE - Visa Purchase - Receipt 130600In REDCLIFFE Date 09 Feb 2021 Card 462263xxxxxx7746,,-75.5,3077.47,75.5
10/02/2021,OFFICEWORKS 0430 NORTH LAKES - EFTPOS Purchase - Receipt 59619Date 10 Feb 2021 Time 4:27PM Card 462263xxxxxx7746,,-6.21,3152.97,6.21
10/02/2021,International Transaction Fee - Receipt 189692,,-0.3,3158.88,0.3
10/02/2021,NAME-CHEAP.COM - Visa Purchase - Receipt 189692Foreign Currency Amount: USD 9.06In WWW.NAMECHEA Date 08 Feb 2021 Card 462263xxxxxx7746,,-11.84,3159.18,11.84
10/02/2021,UBER* EATS - Visa Purchase - Receipt 189691In SYDNEY Date 08 Feb 2021 Card 462263xxxxxx7495,,-31,3171.02,31
10/02/2021,WOOLWORTHS 2752 - Visa Purchase - Receipt 189690In KALLANGUR Date 07 Feb 2021 Card 462263xxxxxx7746,,-37.79,3202.02,37.79
10/02/2021,BWS LIQUOUR 2385 - Visa Purchase - Receipt 189689In KALLANGUR Date 07 Feb 2021 Card 462263xxxxxx7746,,-10,3239.81,10
10/02/2021,TRANSLINK - Visa Purchase - Receipt 189688In BRISBANE Date 08 Feb 2021 Card 462263xxxxxx7746,,-20,3249.81,20
9/02/2021,GOURMET MEATS - Visa Purchase - Receipt 192741In MURRUMBA DOW Date 06 Feb 2021 Card 462263xxxxxx7746,,-47.75,3135.51,47.75
9/02/2021,LINKT BRISBANE - Visa Purchase - Receipt 192740In BRISBANE Date 06 Feb 2021 Card 462263xxxxxx7746,,-25.08,3183.26,25.08
8/02/2021,Raiz Investment - Direct Debit - Receipt 130492 fd0d1f0039c94e9f7a,,-20.94,3208.34,20.94
8/02/2021,ALDI STORES - NORTH LA - Visa Purchase - Receipt 193282In NORTH LAKES Date 05 Feb 2021 Card 462263xxxxxx7746,,-14.32,3229.28,14.32
7/02/2021,SQ *MATT FIDDES MARTIA No rth Lakes - EFTPOS Purchase - Receipt 252404Date 07 Feb 2021 Time 1:14PM Card 462263xxxxxx7746,,-2.5,3243.6,2.5
7/02/2021,SQ *MATT FIDDES MARTIA No rth Lakes - EFTPOS Purchase - Receipt 241999Date 07 Feb 2021 Time 1:12PM Card 462263xxxxxx7746,,-5.5,3246.1,5.5
7/02/2021,Lawnton Country Marke - Visa Purchase - Receipt 171738In Lawnton Date 06 Feb 2021 Card 462263xxxxxx7746,,-31,3251.6,31
7/02/2021,AUSSIE SEAFOOD HOUSE - Visa Purchase - Receipt 171737In LAWNTON Date 06 Feb 2021 Card 462263xxxxxx7746,,-39.61,3282.6,39.61
6/02/2021,Kogan MoneyBlackCard          4813635950084279 - BPAY Bill Payment - Receipt 807086 To Kogan MoneyBlackCard 4813635950084279,,-300,3322.21,300
6/02/2021,Telstra Direct Debit - Visa Purchase - Receipt 193569In AUSTRALIA Date 04 Feb 2021 Card 462263xxxxxx7746,,-111.62,3622.21,111.62
5/02/2021,Final leave pay - Internal Transfer - Receipt 633235  0806227416,,-800,3733.83,800
5/02/2021,International Transaction Fee - Receipt 148894,,-0.36,4533.47,0.36
5/02/2021,ADOBE PHOTOGPHY PLAN - Visa Purchase - Receipt 148894Foreign Currency Amount:  0In ADOBE.LY/ENA Date 03 Feb 2021 Card 462263xxxxxx7746,,-14.29,4533.83,14.29
5/02/2021,WOOLWORTHS ONLINE 8843 - Visa Purchase - Receipt 148893In BELLA VISTA Date 03 Feb 2021 Card 462263xxxxxx7746,,-55.84,4548.12,55.84
4/02/2021,TRANSLINK - Visa Purchase - Receipt 112749In BRISBANE Date 02 Feb 2021 Card 462263xxxxxx7746,,-20,3706.5,20
4/02/2021,ALDI STORES - NORTH LA - Visa Purchase - Receipt 112748In NORTH LAKES Date 01 Feb 2021 Card 462263xxxxxx7746,,-39.94,3726.5,39.94
3/02/2021,ALDI STORES - NORTH LA NORTH LAKES - EFTPOS Purchase - Receipt 118267Date 03 Feb 2021 Time 5:14PM Card 462263xxxxxx7746,,-25.55,3766.44,25.55
2/02/2021,Raiz Maint Fee - Direct Debit - Receipt 118239 d5c11e90429db40102,,-2.5,3791.99,2.5
2/02/2021,UBER* EATS - Visa Purchase - Receipt 185818In SYDNEY Date 31 Jan 2021 Card 462263xxxxxx7495,,-39.79,3794.49,39.79
2/02/2021,Kmart Photo Centre - Visa Purchase - Receipt 185817In 5855300014 Date 01 Feb 2021 Card 462263xxxxxx7746,,-0.45,3834.28,0.45
2/02/2021,WOOLWORTHS 2624 - Visa Purchase - Receipt 185816In CURRIMUNDI Date 30 Jan 2021 Card 462263xxxxxx7746,,-10.5,3834.73,10.5
1/02/2021,Raiz Investment - Direct Debit - Receipt 131663 25c44f8953a5aee845,,-22.44,3845.23,22.44
1/02/2021,PLINE PH WESTFIELD NL  NO RTH LAKES  Q - EFTPOS Purchase - Receipt 11702Date 01 Feb 2021 Time 3:30PM Card 462263xxxxxx7495,,-10.35,3867.67,10.35
31/01/2021,SQ *CAFE TWENTY ONE    Ca loundra - EFTPOS Purchase - Receipt 23163Date 31 Jan 2021 Time 11:14AM Card 462263xxxxxx7746,,-44.8,3878.02,44.8
31/01/2021,International Transaction Fee - Receipt 160182,,-0.67,3922.15,0.67
31/01/2021,DNH*GODADDY.COM AUSTRALIA - Visa Purchase - Receipt 160182Foreign Currency Amount:  0In 480-5058855 Date 29 Jan 2021 Card 462263xxxxxx7746,,-26.62,3922.82,26.62
31/01/2021,WOOLWORTHS 2670 - Visa Purchase - Receipt 160181In CALOUNDRA Date 28 Jan 2021 Card 462263xxxxxx7746,,-21.71,3949.44,21.71
31/01/2021,WOOLWORTHS 2670 - Visa Purchase - Receipt 160180In CALOUNDRA Date 29 Jan 2021 Card 462263xxxxxx7746,,-31.56,3971.15,31.56
30/01/2021,PIZZAGUARDI* CALOUNDRA - Visa Purchase - Receipt 197075In CALOUNDRA Date 28 Jan 2021 Card 462263xxxxxx7746,,-16.85,4002.71,16.85
30/01/2021,ALDI STORES - NORTH LA - Visa Purchase - Receipt 197074In NORTH LAKES Date 27 Jan 2021 Card 462263xxxxxx7495,,-34.4,4019.56,34.4
29/01/2021,SQ *BE AMAZED ENTERTAI Ca loundra - EFTPOS Purchase - Receipt 398371Date 29 Jan 2021 Time 8:51PM Card 462263xxxxxx7746,,-15,4053.96,15
29/01/2021,AMZNPRIMEAU MEMBERSHIP - Visa Purchase - Receipt 132038In SYDNEY SOUTH Date 28 Jan 2021 Card 462263xxxxxx7746,,-6.99,4068.96,6.99
29/01/2021,AZMAN HAROON - Visa Purchase - Receipt 132037In NORTH LAKES Date 27 Jan 2021 Card 462263xxxxxx7495,,-50.45,4075.95,50.45
29/01/2021,Cotton On - Visa Purchase - Receipt 132036In Geelong Date 27 Jan 2021 Card 462263xxxxxx7746,,-19.8,4126.4,19.8
28/01/2021,International Transaction Fee - Receipt 133349,,-2.06,4144.14,2.06
28/01/2021,The Baby Factory NZ Ltd - Visa Purchase - Receipt 133349Foreign Currency Amount: NZD 87.87In East Tamaki Date 27 Jan 2021 Card 462263xxxxxx7495,,-82.27,4146.2,82.27
27/01/2021,Internal Transfer - Internal Transfer - Receipt 119689  0806227416,,-200,4228.47,200
27/01/2021,ALDI STORES - NORTH LA - Visa Purchase - Receipt 136329In NORTH LAKES Date 24 Jan 2021 Card 462263xxxxxx7746,,-66.43,4428.47,66.43
26/01/2021,BIG W 0246 - Visa Purchase - Receipt 115077In NORTHLAKES Date 23 Jan 2021 Card 462263xxxxxx7746,,-43.99,3213.1,43.99
25/01/2021,Microsoft*EA Play 1 Month - Visa Purchase - Receipt 135736In msbill.info Date 24 Jan 2021 Card 462263xxxxxx7746,,-6.99,3257.09,6.99
24/01/2021,BWS 2482 - Visa Purchase - Receipt 139575In GRIFFIN Date 22 Jan 2021 Card 462263xxxxxx7746,,-16,3264.08,16
24/01/2021,WOOLWORTHS ONLINE 8843 - Visa Purchase - Receipt 139574In BELLA VISTA Date 22 Jan 2021 Card 462263xxxxxx7746,,-47.92,3280.08,47.92
24/01/2021,Audible Australia - Visa Purchase - Receipt 139573In MELBOURNE Date 22 Jan 2021 Card 462263xxxxxx7746,,-16.45,3328,16.45
23/01/2021,Kogan MoneyBlackCard          4813635950084279 - BPAY Bill Payment - Receipt 437828 To Kogan MoneyBlackCard 4813635950084279,,-1000,3344.45,1000
22/01/2021,SQ *BROW N LASH EXPRES Mu rrumba Down - EFTPOS Purchase - Receipt 475232Date 22 Jan 2021 Time 4:41PM Card 462263xxxxxx7495,,-15,4340.9,15
22/01/2021,AGL SALES PTY LTD - Visa Purchase - Receipt 187376In SYDNEY Date 20 Jan 2021 Card 462263xxxxxx7746,,-38.76,4355.9,38.76
21/01/2021,MSFT *<E0400D5J4X> - Visa Purchase - Receipt 149257In MSFT AZURE Date 19 Jan 2021 Card 462263xxxxxx7746,,-3.42,4329.66,3.42
20/01/2021,Raiz Investment - Direct Debit - Receipt 113185 bec697437d59b6d8b4,,-25.97,4333.08,25.97
20/01/2021,NETFLIX.COM - Visa Purchase - Receipt 103970In Melbourne Date 18 Jan 2021 Card 462263xxxxxx7746,,-15.99,4359.05,15.99
19/01/2021,CASHCARD\7-ELEVEN GRIFFIN 4266\GRIFFI - Receipt 4406ATM owner fee of $2.50 charged by CASHCARD\7-ELEVEN GRIFFIN 4266\GRIFFIDate 19 Jan 2021 Time 8:54AM Card 462263xxxxxx7746,,-62.5,4372.54,62.5
19/01/2021,FORTIFY PHYSIO - Visa Purchase - Receipt 181432In NORTH LAKES Date 18 Jan 2021 Card 462263xxxxxx7746,,-69,4435.04,69
19/01/2021,AZMAN HAROON - Visa Purchase - Receipt 181431In NORTH LAKES Date 17 Jan 2021 Card 462263xxxxxx7746,,-20.48,4504.04,20.48
19/01/2021,MEATLAND - Visa Purchase - Receipt 181430In NORTH LAKES Date 16 Jan 2021 Card 462263xxxxxx7746,,-52.32,4524.52,52.32
19/01/2021,IKEA NORTHLAKES - Visa Purchase - Receipt 181429In NORTH LAKES Date 17 Jan 2021 Card 462263xxxxxx7746,,-1.5,4576.84,1.5
19/01/2021,WOOLWORTHS ONLINE 8843 - Visa Purchase - Receipt 181428In BELLA VISTA Date 17 Jan 2021 Card 462263xxxxxx7746,,-30.28,4578.34,30.28
18/01/2021,LEASE PAY - Direct Debit - Receipt 117888 001-1347737-001,,-761,4608.62,761
18/01/2021,OFFICEWORKS 0430 NORTH LAKES - EFTPOS Purchase - Receipt 84729Date 18 Jan 2021 Time 5:01PM Card 462263xxxxxx7746,,-19.99,5369.62,19.99
18/01/2021,International Transaction Fee - Receipt 189083,,-0.07,5389.54,0.07
18/01/2021,NEST TECHNOLOGIES CORP - Visa Purchase - Receipt 189083Foreign Currency Amount: USD 2In 7036531100 Date 16 Jan 2021 Card 462263xxxxxx7746,,-2.6,5389.61,2.6
18/01/2021,MICROSOFT*MICROSOFT 365 P - Visa Purchase - Receipt 189082In MSBILL.INFO Date 16 Jan 2021 Card 462263xxxxxx7746,,-10,5392.21,10
18/01/2021,COSTCO FUEL NORTH LAKE - Visa Purchase - Receipt 189081In NORTH LAKES Date 16 Jan 2021 Card 462263xxxxxx7746,,-49.85,5402.21,49.85
18/01/2021,Lawnton Country Marke - Visa Purchase - Receipt 189080In Lawnton Date 17 Jan 2021 Card 462263xxxxxx7746,,-34.24,5452.06,34.24
17/01/2021,KMART 1228 NORTH LAKES - EFTPOS Purchase - Receipt 47113Date 17 Jan 2021 Time 2:01PM Card 462263xxxxxx7746,,-9,5486.3,9
17/01/2021,IKEA NORTHLAKES NORTH LAKES - EFTPOS Purchase - Receipt 350131Date 17 Jan 2021 Time 1:47PM Card 462263xxxxxx7746,,-4.5,5495.3,4.5
17/01/2021,IKEA NORTHLAKES NORTH LAKES - EFTPOS Purchase - Receipt 221572Date 17 Jan 2021 Time 1:45PM Card 462263xxxxxx7746,,-32.96,5499.8,32.96
17/01/2021,IKEA NORTHLAKES NORTH LAKES - EFTPOS Purchase - Receipt 238801Date 17 Jan 2021 Time 12:40PM Card 462263xxxxxx7746,,-20.9,5532.76,20.9
17/01/2021,BIG W 0246 - Visa Purchase - Receipt 180171In NORTHLAKES Date 14 Jan 2021 Card 462263xxxxxx7746,,-13,5553.66,13
17/01/2021,AIRBNB * HMEMJM3NQS - Visa Purchase - Receipt 180170In SURRY HILLS Date 15 Jan 2021 Card 462263xxxxxx7746,,-216.61,5566.66,216.61
17/01/2021,ROCKS CAFE AND BOATHIR - Visa Purchase - Receipt 180169In GRIFFIN Date 15 Jan 2021 Card 462263xxxxxx7746,,-16,5783.27,16
17/01/2021,All Direct debits - Transfer to Kiran Joy - Receipt 478809 To 032885 5310008,,-3100,5799.27,3100
16/01/2021,BWS LIQUOUR 2385 - Visa Purchase - Receipt 111750In KALLANGUR Date 13 Jan 2021 Card 462263xxxxxx7746,,-15,8899.27,15
16/01/2021,Internal Transfer - Internal Transfer - Receipt 589352 Orange Everyday 0065083812,,-345,8914.27,345
16/01/2021,Internal Transfer - Internal Transfer - Receipt 353533 Savings Maximiser 0046211453,,-1180,9259.27,1180
16/01/2021,Internal Transfer - Internal Transfer - Receipt 353352 Savings Maximiser 0046211237,,-690,10439.27,690
16/01/2021,Internal Transfer - Internal Transfer - Receipt 938170  0806227416,,-100,11129.27,100
15/01/2021,DISNEY PLUS - Visa Purchase - Receipt 162503In RICHMOND Date 13 Jan 2021 Card 462263xxxxxx7746,,-8.99,11229.27,8.99
15/01/2021,ALDI STORES - NORTH LA - Visa Purchase - Receipt 162502In NORTH LAKES Date 12 Jan 2021 Card 462263xxxxxx7746,,-11.13,11238.26,11.13
15/01/2021,Vodafone Australia - Visa Purchase - Receipt 162501In North Sydney Date 13 Jan 2021 Card 462263xxxxxx7746,,-69.59,11249.39,69.59
15/01/2021,WOOLWORTHS ONLINE 8843 - Visa Purchase - Receipt 162500In BELLA VISTA Date 13 Jan 2021 Card 462263xxxxxx7746,,-82.49,11318.98,82.49
15/01/2021,WOOLWORTHS 2752 - Visa Purchase - Receipt 162499In KALLANGUR Date 13 Jan 2021 Card 462263xxxxxx7746,,-22.04,11401.47,22.04
14/01/2021,Raiz Investment - Direct Debit - Receipt 170353 82d94d42d7ff60b54f,,-20.85,11423.51,20.85
14/01/2021,SHAPLAND SWIM KALLAN - Visa Purchase - Receipt 135266In KALLANGUR Date 13 Jan 2021 Card 462263xxxxxx7746,,-82,3975.03,82
14/01/2021,ALDI STORES - KALLANGU - Visa Purchase - Receipt 135265In KALLANGUR Date 11 Jan 2021 Card 462263xxxxxx7746,,-85.28,4057.03,85.28
14/01/2021,COSTCO WHOLESALE AUS - Visa Purchase - Receipt 135264In NORTH LAKES Date 12 Jan 2021 Card 462263xxxxxx7746,,-128.44,4142.31,128.44
13/01/2021,OXFAM AUSTRALIA Q - Visa Purchase - Receipt 147544In CARLTON Date 11 Jan 2021 Card 462263xxxxxx7746,,-55,4270.75,55
13/01/2021,Internal Transfer - Internal Transfer - Receipt 854382  0806227416,,-200,4325.75,200
12/01/2021,UBER* EATS - Visa Purchase - Receipt 195210In SYDNEY Date 11 Jan 2021 Card 462263xxxxxx7495,,-25.7,3243.95,25.7
12/01/2021,FORTIFY PHYSIO - Visa Purchase - Receipt 195209In NORTH LAKES Date 11 Jan 2021 Card 462263xxxxxx7746,,-60,3269.65,60
12/01/2021,WOOLWORTHS ONLINE 8843 - Visa Purchase - Receipt 195208In BELLA VISTA Date 09 Jan 2021 Card 462263xxxxxx7746,,-35.97,3329.65,35.97
11/01/2021,AMAZON MKTPLC AU - Visa Purchase - Receipt 148000In SYDNEY SOUTH Date 03 Jan 2021 Card 462263xxxxxx7746,,-40.73,3365.62,40.73
10/01/2021,AMAZON MKTPLC AU - Visa Purchase - Receipt 142973In SYDNEY SOUTH Date 03 Jan 2021 Card 462263xxxxxx7746,,-8.61,3406.35,8.61
10/01/2021,UBER* EATS - Visa Purchase - Receipt 142972In SYDNEY Date 08 Jan 2021 Card 462263xxxxxx7495,,-30,3414.96,30
10/01/2021,BWS 2482 - Visa Purchase - Receipt 142971In GRIFFIN Date 08 Jan 2021 Card 462263xxxxxx7746,,-16,3444.96,16
10/01/2021,ALDI STORES - KALLANGU - Visa Purchase - Receipt 142970In KALLANGUR Date 07 Jan 2021 Card 462263xxxxxx7746,,-35.94,3460.96,35.94
9/01/2021,ALDI STORES - NORTH LA - Visa Purchase - Receipt 101185In NORTH LAKES Date 06 Jan 2021 Card 462263xxxxxx7746,,-23.09,3496.9,23.09
8/01/2021,COLES 4561 MURRUMBA DW - EFTPOS Purchase - Receipt 170211Date 08 Jan 2021 Time 4:37PM Card 462263xxxxxx7746,,-28.66,3519.99,28.66
7/01/2021,Goodstart Murrum - Direct Debit - Receipt 138020 A0064MCY0WVW,,-237.19,3548.65,237.19
7/01/2021,BRIGHT SHADOW TRADIN   GR IFFIN      Q - EFTPOS Purchase - Receipt 61003Date 07 Jan 2021 Time 11:19AM Card 462263xxxxxx7746,,-4,3785.84,4
7/01/2021,GRIFFIN C D PHARMACY - Visa Purchase - Receipt 148682In GRIFFIN Date 06 Jan 2021 Card 462263xxxxxx7746,,-16.99,3789.84,16.99
7/01/2021,MCDONALDS MURRUMBA DO - Visa Purchase - Receipt 148681In MURRUMBA DOW Date 04 Jan 2021 Card 462263xxxxxx7746,,-20.15,3806.83,20.15
7/01/2021,MCDONALDS MURRUMBA DO - Visa Purchase - Receipt 148680In MURRUMBA DOW Date 04 Jan 2021 Card 462263xxxxxx7746,,-8.1,3826.98,8.1
7/01/2021,ANUPSPORTSS - Visa Purchase - Receipt 148679In 0435637487 Date 05 Jan 2021 Card 462263xxxxxx7746,,-21.55,3835.08,21.55
7/01/2021,Telstra Direct Debit - Visa Purchase - Receipt 148678In AUSTRALIA Date 05 Jan 2021 Card 462263xxxxxx7746,,-111.62,3856.63,111.62
7/01/2021,AGL SALES PTY LTD - Visa Purchase - Receipt 148677In SYDNEY Date 05 Jan 2021 Card 462263xxxxxx7746,,-304.59,3968.25,304.59
6/01/2021,RADHE SPICE PTY LTD    NO RTH LAKES  Q - EFTPOS Purchase - Receipt 35495Date 06 Jan 2021 Time 4:16PM Card 462263xxxxxx7746,,-13.48,4272.84,13.48
6/01/2021,COLES 4561 - Visa Purchase - Receipt 165593In MURRUMBA DWN Date 05 Jan 2021 Card 462263xxxxxx7746,,-11.07,4286.32,11.07
6/01/2021,GOURMET MEATS - Visa Purchase - Receipt 165592In MURRUMBA DOW Date 05 Jan 2021 Card 462263xxxxxx7746,,-37.05,4297.39,37.05
6/01/2021,KALLANGUR GROCERS - Visa Purchase - Receipt 165591In KALLANGUR Date 04 Jan 2021 Card 462263xxxxxx7746,,-7.9,4334.44,7.9
6/01/2021,BIG W 0246 - Visa Purchase - Receipt 165590In NORTHLAKES Date 04 Jan 2021 Card 462263xxxxxx7746,,-19,4342.34,19
5/01/2021,International Transaction Fee - Receipt 117551,,-0.36,3410.98,0.36
5/01/2021,ADOBE PHOTOGPHY PLAN - Visa Purchase - Receipt 117551Foreign Currency Amount:  0In ADOBE.LY/ENA Date 03 Jan 2021 Card 462263xxxxxx7746,,-14.29,3411.34,14.29
5/01/2021,GRIFFIN C D PHARMACY - Visa Purchase - Receipt 117550In GRIFFIN Date 04 Jan 2021 Card 462263xxxxxx7746,,-39.94,3425.63,39.94
5/01/2021,CHEMIST WAREHOUSE - Visa Purchase - Receipt 117549In LAWNTON Date 02 Jan 2021 Card 462263xxxxxx7746,,-43.96,3465.57,43.96
5/01/2021,WOOLWORTHS ONLINE 8843 - Visa Purchase - Receipt 117548In BELLA VISTA Date 02 Jan 2021 Card 462263xxxxxx7746,,-49.39,3509.53,49.39
5/01/2021,PAYPAL *NATALIE69 EBAY - Visa Purchase - Receipt 117547In 4029357733 Date 03 Jan 2021 Card 462263xxxxxx7746,,-48,3558.92,48
5/01/2021,ALDI STORES - KALLANGU - Visa Purchase - Receipt 117546In KALLANGUR Date 02 Jan 2021 Card 462263xxxxxx7746,,-28.08,3606.92,28.08
5/01/2021,BUNNINGS 577000 - Visa Purchase - Receipt 117545In LAWNTON Date 02 Jan 2021 Card 462263xxxxxx7746,,-6.15,3635,6.15
4/01/2021,Raiz Investment - Direct Debit - Receipt 180291 ca1ce1be7ea16f08a6,,-20.13,3641.15,20.13
4/01/2021,Raiz Maint Fee - Direct Debit - Receipt 180290 210984cd994b9a6628,,-2.5,3661.28,2.5
4/01/2021,WOOLWORTHS      2508   NO RTH LAKES QL - EFTPOS Purchase - Receipt 806556Date 04 Jan 2021 Time 1:22PM Card 462263xxxxxx7746,,-31.95,3663.78,31.95
3/01/2021,Lawnton Country Marke - Visa Purchase - Receipt 120365In Lawnton Date 02 Jan 2021 Card 462263xxxxxx7746,,-20.34,3695.73,20.34
3/01/2021,PRIMEVIDEO - Visa Purchase - Receipt 120364In SYDNEY Date 01 Jan 2021 Card 462263xxxxxx7746,,-4.99,3716.07,4.99
3/01/2021,BUNNINGS 432000 - Visa Purchase - Receipt 120363In ROTHWELL Date 31 Dec 2020 Card 462263xxxxxx7746,,-34.48,3721.06,34.48
2/01/2021,COLES 4561 - Visa Purchase - Receipt 103001In MURRUMBA DWN Date 01 Jan 2021 Card 462263xxxxxx7746,,-31.47,3755.54,31.47
2/01/2021,MCDONALDS STAFFORD - Visa Purchase - Receipt 103000In STAFFORD Date 30 Dec 2020 Card 462263xxxxxx7746,,-4.95,3787.01,4.95
1/01/2021,UBER* EATS - Visa Purchase - Receipt 134911In SYDNEY Date 30 Dec 2020 Card 462263xxxxxx7495,,-44.99,3791.96,44.99
1/01/2021,UBER   *EATS - Visa Purchase - Receipt 134910In SYDNEY Date 30 Dec 2020 Card 462263xxxxxx7495,,-2.24,3836.95,2.24
1/01/2021,BUNNINGS 376000 - Visa Purchase - Receipt 134909In NORTH LAKES Date 29 Dec 2020 Card 462263xxxxxx7746,,-9.5,3839.19,9.5
31/12/2020,Goodstart Murrum - Direct Debit - Receipt 127429 A0063N3E0SLS,,-177.91,3848.69,177.91
31/12/2020,BONDS ONLINE - Visa Purchase - Receipt 158061In KEW Date 28 Dec 2020 Card 462263xxxxxx7746,,-43.11,4026.6,43.11
31/12/2020,COSTCO FUEL NORTH LAKE - Visa Purchase - Receipt 158060In NORTH LAKES Date 29 Dec 2020 Card 462263xxxxxx7746,,-57.43,4069.71,57.43
31/12/2020,WOOLWORTHS 2508 - Visa Purchase - Receipt 158059In MANGO HILL Date 29 Dec 2020 Card 462263xxxxxx7746,,-13.2,4127.14,13.2
30/12/2020,BIG W 0246 - Visa Purchase - Receipt 195516In NORTHLAKES Date 26 Dec 2020 Card 462263xxxxxx7746,,-76,4125.37,76
30/12/2020,WOOLWORTHS 2508 - Visa Purchase - Receipt 195515In MANGO HILL Date 24 Dec 2020 Card 462263xxxxxx7746,,-13,4201.37,13
29/12/2020,Raiz Investment - Direct Debit - Receipt 101437 d7ccd9d23019dc27e9,,-20.05,4214.37,20.05
29/12/2020,Internal Transfer - Internal Transfer - Receipt 592961  0806227416,,-100,4234.42,100
29/12/2020,AMZNPRIMEAU MEMBERSHIP - Visa Purchase - Receipt 163453In SYDNEY SOUTH Date 28 Dec 2020 Card 462263xxxxxx7746,,-6.99,4334.42,6.99
28/12/2020,BSKIDS - Visa Purchase - Receipt 110861In 0422556527 Date 25 Dec 2020 Card 462263xxxxxx7746,,-38.95,3059.61,38.95
26/12/2020,BIG W 0246 - Visa Purchase - Receipt 136329In NORTHLAKES Date 24 Dec 2020 Card 462263xxxxxx7746,,-24,3098.56,24
25/12/2020,Microsoft*EA Play 1 Month - Visa Purchase - Receipt 103574In msbill.info Date 24 Dec 2020 Card 462263xxxxxx7746,,-6.99,3122.56,6.99
25/12/2020,UBER   *EATS - Visa Purchase - Receipt 103573In SYDNEY Date 23 Dec 2020 Card 462263xxxxxx7495,,-1.96,3129.55,1.96
25/12/2020,LINKT BRISBANE - Visa Purchase - Receipt 103572In BRISBANE Date 23 Dec 2020 Card 462263xxxxxx7746,,-25.08,3131.51,25.08
24/12/2020,Goodstart Murrum - Direct Debit - Receipt 118863 A0062LGU0ZD5,,-237.28,3156.59,237.28
24/12/2020,UBER* EATS - Visa Purchase - Receipt 118404In SYDNEY Date 23 Dec 2020 Card 462263xxxxxx7495,,-36.34,3393.87,36.34
24/12/2020,FUELLED CAFE - Visa Purchase - Receipt 118403In SOUTH BRISBA Date 22 Dec 2020 Card 462263xxxxxx7746,,-48,3430.21,48
24/12/2020,UBER* EATS - Visa Purchase - Receipt 118402In SYDNEY Date 22 Dec 2020 Card 462263xxxxxx7495,,-32.45,3478.21,32.45
24/12/2020,ALDI STORES - KALLANGU - Visa Purchase - Receipt 118401In KALLANGUR Date 21 Dec 2020 Card 462263xxxxxx7746,,-69.67,3510.66,69.67
24/12/2020,WOOLWORTHS ONLINE 8843 - Visa Purchase - Receipt 118400In BELLA VISTA Date 22 Dec 2020 Card 462263xxxxxx7746,,-40.9,3580.33,40.9
24/12/2020,Audible Australia - Visa Purchase - Receipt 118399In MELBOURNE Date 22 Dec 2020 Card 462263xxxxxx7746,,-16.45,3621.23,16.45
23/12/2020,International Transaction Fee - Receipt 181197,,-2.18,3635.5,2.18
23/12/2020,"AMAZON PAY - Visa Purchase - Receipt 181197Foreign Currency Amount: INR 4,783.06In BANGALORE Date 21 Dec 2020 Card 462263xxxxxx7746",,-87.15,3637.68,87.15
23/12/2020,NETFLIX COM - Visa Purchase - Receipt 181196In MELBOURNE Date 19 Dec 2020 Card 462263xxxxxx7746,,-15.99,3724.83,15.99
22/12/2020,GOURMET MEATS - Visa Purchase - Receipt 151627In MURRUMBA DOW Date 19 Dec 2020 Card 462263xxxxxx7746,,-34.35,3740.82,34.35
22/12/2020,WU 2035487747344031 - Visa Purchase - Receipt 151626In 1800173833 Date 20 Dec 2020 Card 462263xxxxxx7746,,-1402.9,3775.17,1402.9
22/12/2020,BWS 2482 - Visa Purchase - Receipt 151625In GRIFFIN Date 19 Dec 2020 Card 462263xxxxxx7746,,-17,5178.07,17
22/12/2020,COTTON ON KIDS 4223 - Visa Purchase - Receipt 151624In MANGO HILL Date 19 Dec 2020 Card 462263xxxxxx7495,,-19.99,5195.07,19.99
22/12/2020,WOOLWORTHS 2575 - Visa Purchase - Receipt 151623In STRATHPINE Date 18 Dec 2020 Card 462263xxxxxx7746,,-37.03,5215.06,37.03
22/12/2020,BIG W 0246 - Visa Purchase - Receipt 151622In NORTHLAKES Date 19 Dec 2020 Card 462263xxxxxx7495,,-19.95,5252.09,19.95
21/12/2020,Raiz Investment - Direct Debit - Receipt 143940 d51b27d0232243efdd,,-21.97,5272.04,21.97
21/12/2020,International Transaction Fee - Receipt 125177,,-1.21,5227.8,1.21
21/12/2020,Patpat.com - Visa Purchase - Receipt 125177Foreign Currency Amount:  0In Dublin Date 19 Dec 2020 Card 462263xxxxxx7746,,-48.21,5229.01,48.21
21/12/2020,MSFT *<E0400CUZN5> - Visa Purchase - Receipt 125176In MSFT AZURE Date 19 Dec 2020 Card 462263xxxxxx7746,,-2.87,5277.22,2.87
20/12/2020,BIG W ONLINE 0800 - Visa Purchase - Receipt 178559In BELLA VISTA Date 18 Dec 2020 Card 462263xxxxxx7746,,-87.81,5280.09,87.81
20/12/2020,WOOLWORTHS ONLINE 8843 - Visa Purchase - Receipt 178558In BELLA VISTA Date 18 Dec 2020 Card 462263xxxxxx7746,,-53.95,5367.9,53.95
20/12/2020,BIG W ONLINE 0800 - Visa Purchase - Receipt 178557In BELLA VISTA Date 18 Dec 2020 Card 462263xxxxxx7746,,-35.5,5421.85,35.5
19/12/2020,COLES 4561 MURRUMBA DW - EFTPOS Purchase - Receipt 400325Date 19 Dec 2020 Time 4:56PM Card 462263xxxxxx7746,,-21.63,5457.35,21.63
19/12/2020,THESMITHFAMILY.COM.AU - Visa Purchase - Receipt 134513In SYDNEY Date 17 Dec 2020 Card 462263xxxxxx7746,,-31.2,5478.98,31.2
19/12/2020,COSTCO WHOLESALE AUS - Visa Purchase - Receipt 134512In NORTH LAKES Date 17 Dec 2020 Card 462263xxxxxx7746,,-97.47,5510.18,97.47
18/12/2020,rediATM 1473 Anzac Ave Ka llangur    0 - Receipt 6689ATM owner fee of $2.50 charged by rediATM 1473 Anzac Ave Ka llangur    0Date 18 Dec 2020 Time 12:34PM Card 462263xxxxxx7746,,-62.5,5605.15,62.5
18/12/2020,HERO SUSHI NORTH LAKES - Visa Purchase - Receipt 181273In NORTH LAKES Date 17 Dec 2020 Card 462263xxxxxx7746,,-19,5667.65,19
18/12/2020,BIG W ONLINE 0800 - Visa Purchase - Receipt 181272In BELLA VISTA Date 16 Dec 2020 Card 462263xxxxxx7746,,-31.2,5686.65,31.2
17/12/2020,LEASE PAY - Direct Debit - Receipt 122124 001-1347737-001,,-761,5717.85,761
17/12/2020,Goodstart Murrum - Direct Debit - Receipt 111514 A0061QUW0YUM,,-237.23,6478.85,237.23
17/12/2020,All Direct debits - Transfer to Kiran Joy - Receipt 464911 To 032885 5310008,,-3100,6716.08,3100
17/12/2020,International Transaction Fee - Receipt 140221,,-1.59,9814.49,1.59
17/12/2020,Banggood.com - Visa Purchase - Receipt 140221Foreign Currency Amount:  0In HongKong Date 16 Dec 2020 Card 462263xxxxxx7746,,-63.63,9816.08,63.63
17/12/2020,Microsoft*Microsoft 365 P - Visa Purchase - Receipt 140220In msbill.info Date 16 Dec 2020 Card 462263xxxxxx7746,,-10,9879.71,10
17/12/2020,EBAY INTL AG - AU - Visa Purchase - Receipt 140219In 888-749-3229 Date 15 Dec 2020 Card 462263xxxxxx7746,,-48.99,9889.71,48.99
17/12/2020,JAY MEDICALS PTY LTD - Visa Purchase - Receipt 140218In GRIFFIN Date 15 Dec 2020 Card 462263xxxxxx7495,,-110,9938.7,110
17/12/2020,BRIGHT SHADOW TRADIN - Visa Purchase - Receipt 140217In GRIFFIN Date 15 Dec 2020 Card 462263xxxxxx7746,,-9,10048.7,9
17/12/2020,KMART ONLINE - Visa Purchase - Receipt 140216In 03 Date 16 Dec 2020 Card 462263xxxxxx7746,,-79,10057.7,79
16/12/2020,MURRUMBA DOWN TAVER    MU RRUMBA DOWNS - EFTPOS Purchase - Receipt 19822Date 16 Dec 2020 Time 8:36PM Card 462263xxxxxx7746,,-71,10136.7,71
16/12/2020,Internal Transfer - Internal Transfer - Receipt 532135  0806227416,,-100,10207.7,100
16/12/2020,Internal Transfer - Internal Transfer - Receipt 309772 Savings Maximiser 0046211453,,-1180,10307.7,1180
16/12/2020,Internal Transfer - Internal Transfer - Receipt 309328 Savings Maximiser 0046211237,,-690,11487.7,690
16/12/2020,Internal Transfer - Internal Transfer - Receipt 757322 Orange Everyday 0065083812,,-345,12177.7,345
16/12/2020,TRANSPORTMAINRDS - Visa Purchase - Receipt 125988In BRISBANE Date 14 Dec 2020 Card 462263xxxxxx7746,,-449.83,12522.7,449.83
16/12/2020,WOOLWORTHS 2752 - Visa Purchase - Receipt 125987In KALLANGUR Date 14 Dec 2020 Card 462263xxxxxx7746,,-25.35,12972.53,25.35
15/12/2020,Internal Transfer - Internal Transfer - Receipt 465097  0806227416,,-200,11628.63,200
15/12/2020,DISNEY PLUS - Visa Purchase - Receipt 169433In RICHMOND Date 13 Dec 2020 Card 462263xxxxxx7746,,-8.99,11828.63,8.99
15/12/2020,AIRBNB * HMEMJM3NQS - Visa Purchase - Receipt 169432In SURRY HILLS Date 13 Dec 2020 Card 462263xxxxxx7746,,-216.62,11837.62,216.62
15/12/2020,UBER   *EATS - Visa Purchase - Receipt 169431In SYDNEY Date 13 Dec 2020 Card 462263xxxxxx7495,,-22,12054.24,22
14/12/2020,Raiz Investment - Direct Debit - Receipt 185184 1092e4ca0e00cb8d0b,,-20.54,776.91,20.54
14/12/2020,KMART 1228 NORTH LAKES - EFTPOS Purchase - Receipt 231782Date 14 Dec 2020 Time 2:16PM Card 462263xxxxxx7746,,-15,797.45,15
14/12/2020,IKEA NORTHLAKES NORTH LAKES - EFTPOS Purchase - Receipt 234201Date 14 Dec 2020 Time 1:44PM Card 462263xxxxxx7746,,-22.4,812.45,22.4
14/12/2020,IKEA NORTHLAKES NORTH LAKES - EFTPOS Purchase - Receipt 224216Date 14 Dec 2020 Time 1:26PM Card 462263xxxxxx7746,,-61.95,834.85,61.95
14/12/2020,UBER* EATS - Visa Purchase - Receipt 122159In SYDNEY Date 13 Dec 2020 Card 462263xxxxxx7495,,-1.39,896.8,1.39
13/12/2020,RADHE SPICE PTY LTD - Visa Purchase - Receipt 179319In NORTH LAKES Date 10 Dec 2020 Card 462263xxxxxx7746,,-4.49,898.19,4.49
13/12/2020,RADHE SPICE PTY LTD - Visa Purchase - Receipt 179318In NORTH LAKES Date 10 Dec 2020 Card 462263xxxxxx7746,,-67.89,902.68,67.89
12/12/2020,COLES 4561 MURRUMBA DW - EFTPOS Purchase - Receipt 289590Date 12 Dec 2020 Time 5:16PM Card 462263xxxxxx7746,,-27.85,970.57,27.85
12/12/2020,WOOLWORTHS ONLINE 8843 - Visa Purchase - Receipt 100265In BELLA VISTA Date 10 Dec 2020 Card 462263xxxxxx7746,,-38.96,998.42,38.96
12/12/2020,ALDI STORES - KALLANGU - Visa Purchase - Receipt 100264In KALLANGUR Date 09 Dec 2020 Card 462263xxxxxx7746,,-28.11,1037.38,28.11
12/12/2020,ALDI STORES - NORTH LA - Visa Purchase - Receipt 100263In NORTH LAKES Date 09 Dec 2020 Card 462263xxxxxx7495,,-17.11,1065.49,17.11
12/12/2020,OXFAM AUSTRALIA Q - Visa Purchase - Receipt 100262In CARLTON Date 10 Dec 2020 Card 462263xxxxxx7746,,-55,1082.6,55
11/12/2020,AZMAN HAROON - Visa Purchase - Receipt 136435In NORTH LAKES Date 09 Dec 2020 Card 462263xxxxxx7495,,-91.96,1137.6,91.96
11/12/2020,Vodafone Australia - Visa Purchase - Receipt 136434In North Sydney Date 09 Dec 2020 Card 462263xxxxxx7746,,-69.58,1229.56,69.58
10/12/2020,Goodstart Murrum - Direct Debit - Receipt 115820 A0060NRA141Q,,-237.23,1299.14,237.23
10/12/2020,International Transaction Fee - Receipt 193747,,-0.75,1535.62,0.75
10/12/2020,PAYPAL *XIANGZEDAKE EB - Visa Purchase - Receipt 193747Foreign Currency Amount:  0In 4029357733 Date 08 Dec 2020 Card 462263xxxxxx7746,,-29.99,1536.37,29.99
10/12/2020,SHAPLAND SWIM KALLAN - Visa Purchase - Receipt 193746In KALLANGUR Date 09 Dec 2020 Card 462263xxxxxx7746,,-61.5,1566.36,61.5
10/12/2020,PAYPAL *XINCHENGWAN EB - Visa Purchase - Receipt 193745In 4029357733 Date 08 Dec 2020 Card 462263xxxxxx7746,,-12.95,1627.86,12.95
10/12/2020,eBay O*06-06210-72308 - Visa Purchase - Receipt 193744In Sydney Date 08 Dec 2020 Card 462263xxxxxx7746,,-9.95,1640.81,9.95
10/12/2020,UBER   *EATS - Visa Purchase - Receipt 193743In SYDNEY Date 08 Dec 2020 Card 462263xxxxxx7495,,-42.2,1650.76,42.2
8/12/2020,WOOLWORTHS ONLINE 8843 - Visa Purchase - Receipt 152463In BELLA VISTA Date 06 Dec 2020 Card 462263xxxxxx7746,,-39.75,1692.96,39.75
8/12/2020,WOOLWORTHS 2508 - Visa Purchase - Receipt 152462In MANGO HILL Date 04 Dec 2020 Card 462263xxxxxx7746,,-39,1732.71,39
7/12/2020,Lawnton CM Bakery - Visa Purchase - Receipt 122194In Lawnton Date 06 Dec 2020 Card 462263xxxxxx7746,,-10.6,1771.71,10.6
7/12/2020,Lawnton Country Marke - Visa Purchase - Receipt 122193In Lawnton Date 06 Dec 2020 Card 462263xxxxxx7746,,-29.74,1782.31,29.74
7/12/2020,Warburton Butcher LT - Visa Purchase - Receipt 122192In Lawnton Date 06 Dec 2020 Card 462263xxxxxx7746,,-18.81,1812.05,18.81
7/12/2020,AUSSIE SEAFOOD HOUSE - Visa Purchase - Receipt 122191In LAWNTON Date 06 Dec 2020 Card 462263xxxxxx7746,,-33.72,1830.86,33.72
7/12/2020,ANUPSPORTSS - Visa Purchase - Receipt 122190In 0435637487 Date 05 Dec 2020 Card 462263xxxxxx7746,,-70,1864.58,70
7/12/2020,BUNNINGS 376000 - Visa Purchase - Receipt 122189In NORTH LAKES Date 04 Dec 2020 Card 462263xxxxxx7746,,-82.02,1934.58,82.02
6/12/2020,COSTCO FUEL NORTH LAKE - Visa Purchase - Receipt 143935In NORTH LAKES Date 04 Dec 2020 Card 462263xxxxxx7746,,-62.86,2016.6,62.86
6/12/2020,Telstra Direct Debit - Visa Purchase - Receipt 143934In AUSTRALIA Date 04 Dec 2020 Card 462263xxxxxx7746,,-96.62,2079.46,96.62
6/12/2020,PIZZA HUT MANGO HILL - Visa Purchase - Receipt 143933In MANGO HILL Date 03 Dec 2020 Card 462263xxxxxx7746,,-26.9,2176.08,26.9
5/12/2020,International Transaction Fee - Receipt 183081,,-0.36,2202.62,0.36
5/12/2020,ADOBE PHOTOGPHY PLAN - Visa Purchase - Receipt 183081Foreign Currency Amount:  0In ADOBE.LY/ENA Date 03 Dec 2020 Card 462263xxxxxx7746,,-14.29,2202.98,14.29
5/12/2020,ALDI STORES - KALLANGU - Visa Purchase - Receipt 183080In KALLANGUR Date 02 Dec 2020 Card 462263xxxxxx7746,,-21.75,2217.27,21.75
4/12/2020,BIG W ONLINE 0800 - Visa Purchase - Receipt 127879In BELLA VISTA Date 02 Dec 2020 Card 462263xxxxxx7495,,-55,2239.02,55
4/12/2020,ALDI STORES - KALLANGU - Visa Purchase - Receipt 127878In KALLANGUR Date 01 Dec 2020 Card 462263xxxxxx7746,,-41.7,2294.02,41.7
3/12/2020,Goodstart Murrum - Direct Debit - Receipt 172628 A005ZKS411M4,,-237.23,2335.72,237.23
3/12/2020,KMART ONLINE - Visa Purchase - Receipt 107265In 03 Date 02 Dec 2020 Card 462263xxxxxx7495,,-65,2572.95,65
2/12/2020,Raiz Investment - Direct Debit - Receipt 155681 2407dcc75ddd55345d,,-20.39,2637.95,20.39
2/12/2020,Internal Transfer - Internal Transfer - Receipt 528883  0806227416,,-100,2658.34,100
1/12/2020,Raiz Maint Fee - Direct Debit - Receipt 111080 9a5f92d969066de833,,-2.5,1476.54,2.5
1/12/2020,LILY HEALTH PTY LTD - Visa Purchase - Receipt 186077In NORTH LAKES Date 29 Nov 2020 Card 462263xxxxxx7746,,-68,1479.04,68
1/12/2020,WOOLWORTHS ONLINE 8843 - Visa Purchase - Receipt 186076In BELLA VISTA Date 29 Nov 2020 Card 462263xxxxxx7746,,-52.9,1547.04,52.9
1/12/2020,WOOLWORTHS 2752 - Visa Purchase - Receipt 186075In KALLANGUR Date 28 Nov 2020 Card 462263xxxxxx7746,,-16.01,1599.94,16.01
29/11/2020,AMZNPRIMEAU MEMBERSHIP - Visa Purchase - Receipt 181402In SYDNEY SOUTH Date 28 Nov 2020 Card 462263xxxxxx7746,,-6.99,1615.95,6.99
29/11/2020,PAYPAL *JXCOMPANYPP EB - Visa Purchase - Receipt 181401In 4029357733 Date 27 Nov 2020 Card 462263xxxxxx7746,,-16.99,1622.94,16.99
29/11/2020,PAYPAL *BOOZEBUD EBAY - Visa Purchase - Receipt 181400In 4029357733 Date 26 Nov 2020 Card 462263xxxxxx7746,,-59.99,1639.93,59.99
29/11/2020,WOOLWORTHS 2508 - Visa Purchase - Receipt 181399In MANGO HILL Date 27 Nov 2020 Card 462263xxxxxx7746,,-53,1699.92,53
28/11/2020,COLES 4545 NORTH LAKE - EFTPOS Purchase - Receipt 6816Date 28 Nov 2020 Time 10:55AM Card 462263xxxxxx7746,,-4.78,1752.92,4.78
28/11/2020,WU 2033181729075422 - Visa Purchase - Receipt 105758In 1800173833 Date 26 Nov 2020 Card 462263xxxxxx7746,,-302.9,1757.7,302.9
28/11/2020,UBER   *EATS - Visa Purchase - Receipt 105757In SYDNEY Date 26 Nov 2020 Card 462263xxxxxx7495,,-2.07,2060.6,2.07
28/11/2020,UBER   *EATS - Visa Purchase - Receipt 105756In SYDNEY Date 26 Nov 2020 Card 462263xxxxxx7495,,-34.35,2062.67,34.35
27/11/2020,ALDI STORES - NORTH LA - Visa Purchase - Receipt 111975In NORTH LAKES Date 24 Nov 2020 Card 462263xxxxxx7746,,-5,2097.02,5
26/11/2020,Goodstart Murrum - Direct Debit - Receipt 163637 A005XZ8414HX,,-237.23,2102.02,237.23
26/11/2020,ALDI STORES - KALLANGU - Visa Purchase - Receipt 165139In KALLANGUR Date 23 Nov 2020 Card 462263xxxxxx7746,,-15.1,2339.25,15.1
26/11/2020,Microsoft*EA Play 1 Month - Visa Purchase - Receipt 165138In msbill.info Date 24 Nov 2020 Card 462263xxxxxx7746,,-6.99,2354.35,6.99
26/11/2020,BWS 2482 - Visa Purchase - Receipt 165137In GRIFFIN Date 24 Nov 2020 Card 462263xxxxxx7746,,-7,2361.34,7
25/11/2020,AFTERPAY - Visa Purchase - Receipt 129662In MELBOURNE Date 23 Nov 2020 Card 462263xxxxxx7746,,-4.98,2368.34,4.98
25/11/2020,ALDI STORES - KALLANGU - Visa Purchase - Receipt 129661In KALLANGUR Date 22 Nov 2020 Card 462263xxxxxx7746,,-29.41,2373.32,29.41
24/11/2020,AMAZON AU - Visa Purchase - Receipt 115482In SYDNEY SOUTH Date 20 Nov 2020 Card 462263xxxxxx7746,,-27.49,2382.73,27.49
24/11/2020,WOOLWORTHS 2752 - Visa Purchase - Receipt 115481In KALLANGUR Date 22 Nov 2020 Card 462263xxxxxx7746,,-57.26,2410.22,57.26
24/11/2020,Audible Australia - Visa Purchase - Receipt 115480In MELBOURNE Date 22 Nov 2020 Card 462263xxxxxx7746,,-16.45,2467.48,16.45
23/11/2020,OPTUS BILLING - Direct Debit - Receipt 123973 62173942475,,-48.71,2483.93,48.71
23/11/2020,WU 2032684636095082 - Visa Purchase - Receipt 199203In 1800173833 Date 21 Nov 2020 Card 462263xxxxxx7746,,-302.9,2532.64,302.9
23/11/2020,MSFT *<E0400CKLA8> - Visa Purchase - Receipt 199202In MSFT AZURE Date 20 Nov 2020 Card 462263xxxxxx7746,,-2.83,2835.54,2.83
23/11/2020,COSTCO WHOLESALE AUS - Visa Purchase - Receipt 199201In NORTH LAKES Date 21 Nov 2020 Card 462263xxxxxx7746,,-101.94,2838.37,101.94
21/11/2020,ALDI STORES - KALLANGU - Visa Purchase - Receipt 135208In KALLANGUR Date 18 Nov 2020 Card 462263xxxxxx7746,,-18.32,2940.31,18.32
20/11/2020,Raiz Investment - Direct Debit - Receipt 126137 96bb625a01be10addc,,-28.37,2958.63,28.37
20/11/2020,GRIFFIN C D PHARMACY - Visa Purchase - Receipt 178076In GRIFFIN Date 19 Nov 2020 Card 462263xxxxxx7746,,-18.95,2922,18.95
20/11/2020,SHAPLAND SWIM KALLAN - Visa Purchase - Receipt 178075In KALLANGUR Date 19 Nov 2020 Card 462263xxxxxx7746,,-97,2940.95,97
20/11/2020,NETFLIX.COM - Visa Purchase - Receipt 178074In Melbourne Date 18 Nov 2020 Card 462263xxxxxx7746,,-15.99,3037.95,15.99
20/11/2020,TRANSLINK - Visa Purchase - Receipt 178073In BRISBANE Date 17 Nov 2020 Card 462263xxxxxx7746,,-10,3053.94,10
20/11/2020,GM CABS PTY LTD - Visa Purchase - Receipt 178072In MASCOT Date 18 Nov 2020 Card 462263xxxxxx7495,,-8.93,3063.94,8.93
19/11/2020,Goodstart Murrum - Direct Debit - Receipt 118820 A005WXVD12KR,,-237.23,3072.87,237.23
19/11/2020,UBER   *EATS - Visa Purchase - Receipt 164761In SYDNEY Date 17 Nov 2020 Card 462263xxxxxx7495,,-46.79,3300.1,46.79
18/11/2020,Internal Transfer - Internal Transfer - Receipt 806116  0806227416,,-100,3346.89,100
18/11/2020,PLINE PH ANZAC SQUARE  BR ISBANE CITYQ - EFTPOS Purchase - Receipt 306766Date 18 Nov 2020 Time 11:40AM Card 462263xxxxxx7495,,-2.99,3446.89,2.99
18/11/2020,H&M Brisbane AU0009 170 Queen S - EFTPOS Purchase - Receipt 54208Date 18 Nov 2020 Time 12:32PM Card 462263xxxxxx7495,,-29.99,3449.88,29.99
18/11/2020,MICROSOFT*MICROSOFT 365 P - Visa Purchase - Receipt 149553In MSBILL.INFO Date 16 Nov 2020 Card 462263xxxxxx7746,,-10,3479.87,10
18/11/2020,BRIGHT SHADOW TRADIN - Visa Purchase - Receipt 149552In GRIFFIN Date 14 Nov 2020 Card 462263xxxxxx7746,,-8,3489.87,8
17/11/2020,LEASE PAY - Direct Debit - Receipt 158671 001-1347737-001,,-583,1569.86,583
17/11/2020,MBRC PAYMENTS                 008280976 - BPAY Bill Payment - Receipt 642612 To MBRC PAYMENTS 008280976,,-806.16,2152.86,806.16
17/11/2020,COSTCO FUEL NORTH LAKE NORTH LAKES - EFTPOS Purchase - Receipt 66761Date 17 Nov 2020 Time 4:34PM Card 462263xxxxxx7746,,-64.26,2959.02,64.26
17/11/2020,COSTCO FUEL NORTH LAKE NORTH LAKES - EFTPOS Purchase - Receipt 66759Date 17 Nov 2020 Time 4:34PM Card 462263xxxxxx7746,,-75,2948.28,75
17/11/2020,SP * OIOI PTY LTD - Visa Purchase - Receipt 130506In PORT MELBOUR Date 16 Nov 2020 Card 462263xxxxxx7495,,-145,3008.28,145
17/11/2020,GRIFFIN C D PHARMACY - Visa Purchase - Receipt 130505In GRIFFIN Date 16 Nov 2020 Card 462263xxxxxx7746,,-9.99,3153.28,9.99
17/11/2020,WOOLWORTHS ONLINE 8843 - Visa Purchase - Receipt 130504In BELLA VISTA Date 15 Nov 2020 Card 462263xxxxxx7746,,-38.84,3163.27,38.84
17/11/2020,WOOLWORTHS 2752 - Visa Purchase - Receipt 130503In KALLANGUR Date 15 Nov 2020 Card 462263xxxxxx7746,,-8,3202.11,8
17/11/2020,All Direct debits - Transfer to Kiran Joy - Receipt 237264 To 032885 5310008,,-3100,3210.11,3100
16/11/2020,Wheelhouse Coffee - Visa Purchase - Receipt 196073In Lawnton Date 15 Nov 2020 Card 462263xxxxxx7746,,-10,5996.85,10
16/11/2020,Lawnton Country Marke - Visa Purchase - Receipt 196072In Lawnton Date 15 Nov 2020 Card 462263xxxxxx7746,,-32.97,6006.85,32.97
16/11/2020,AUSSIE SEAFOOD HOUSE - Visa Purchase - Receipt 196071In LAWNTON Date 15 Nov 2020 Card 462263xxxxxx7746,,-31.05,6039.82,31.05
16/11/2020,UBER   *EATS - Visa Purchase - Receipt 196070In SYDNEY Date 14 Nov 2020 Card 462263xxxxxx7495,,-42.85,6070.87,42.85
16/11/2020,Internal Transfer - Internal Transfer - Receipt 753328 Savings Maximiser 0046211453,,-1180,6113.72,1180
16/11/2020,Internal Transfer - Internal Transfer - Receipt 753115 Savings Maximiser 0046211237,,-690,7293.72,690
16/11/2020,Internal Transfer - Internal Transfer - Receipt 627541 Orange Everyday 0065083812,,-345,7983.72,345
15/11/2020,DISNEY PLUS - Visa Purchase - Receipt 107163In RICHMOND Date 13 Nov 2020 Card 462263xxxxxx7746,,-8.99,8328.72,8.99
14/11/2020,PURE ATM MOOLOOLABA - Receipt 587ATM owner fee of $2.80 charged by PURE ATM MOOLOOLABADate 14 Nov 2020 Time 11:05AM Card 462263xxxxxx7746,,-22.8,8334.91,22.8
14/11/2020,SQ *BROW N LASH EXPRES - Visa Purchase - Receipt 129532In Griffin Date 12 Nov 2020 Card 462263xxxxxx7495,,-15,8357.71,15
14/11/2020,RADHE SPICE PTY LTD - Visa Purchase - Receipt 129531In NORTH LAKES Date 11 Nov 2020 Card 462263xxxxxx7746,,-37.93,8372.71,37.93
13/11/2020,Internal Transfer - Internal Transfer - Receipt 97179  0806227416,,-100,8410.64,100
13/11/2020,Vodafone Australia - Visa Purchase - Receipt 196517In North Sydney Date 11 Nov 2020 Card 462263xxxxxx7746,,-69.59,1041.31,69.59
12/11/2020,Goodstart Murrum - Direct Debit - Receipt 138597 A005VP5D13VE,,-300,1110.9,300
12/11/2020,Goodstart Murrum - Direct Debit - Receipt 138596 A005VP5D13VD,,-174.41,1410.9,174.41
12/11/2020,DEBITSSUCESSDF - Direct Debit - Receipt 138595 A005VP5D13VF,,-8.25,1585.31,8.25
12/11/2020,OXFAM AUSTRALIA Q - Visa Purchase - Receipt 142962In CARLTON Date 10 Nov 2020 Card 462263xxxxxx7746,,-55,1593.56,55
12/11/2020,ALDI STORES - KALLANGU - Visa Purchase - Receipt 142961In KALLANGUR Date 09 Nov 2020 Card 462263xxxxxx7746,,-24.4,1648.56,24.4
12/11/2020,BONDS ONLINE - Visa Purchase - Receipt 142960In KEW Date 10 Nov 2020 Card 462263xxxxxx7495,,-26.94,1672.96,26.94
11/11/2020,AFTERPAY - Visa Purchase - Receipt 133093In MELBOURNE Date 09 Nov 2020 Card 462263xxxxxx7746,,-4.99,1699.9,4.99
11/11/2020,ALDI STORES - KALLANGU - Visa Purchase - Receipt 133092In KALLANGUR Date 08 Nov 2020 Card 462263xxxxxx7746,,-37.7,1704.89,37.7
10/11/2020,International Transaction Fee - Receipt 168670,,-0.63,1741.96,0.63
10/11/2020,Patpat.com - Visa Purchase - Receipt 168670Foreign Currency Amount:  0In Dublin Date 09 Nov 2020 Card 462263xxxxxx7746,,-25.27,1742.59,25.27
10/11/2020,BWS 2482 - Visa Purchase - Receipt 168669In GRIFFIN Date 09 Nov 2020 Card 462263xxxxxx7746,,-4,1767.86,4
10/11/2020,WOOLWORTHS ONLINE 8843 - Visa Purchase - Receipt 168668In BELLA VISTA Date 08 Nov 2020 Card 462263xxxxxx7746,,-66.68,1771.86,66.68
10/11/2020,WOOLWORTHS 2752 - Visa Purchase - Receipt 168667In KALLANGUR Date 08 Nov 2020 Card 462263xxxxxx7746,,-30,1838.54,30
9/11/2020,Raiz Investment - Direct Debit - Receipt 103591 bc4a0566cc84834721,,-20.33,1868.54,20.33
8/11/2020,Menulog Pty Ltd - Visa Purchase - Receipt 175935In Sydney Date 06 Nov 2020 Card 462263xxxxxx7746,,-35.01,1538.87,35.01
8/11/2020,Telstra Direct Debit - Visa Purchase - Receipt 175934In AUSTRALIA Date 06 Nov 2020 Card 462263xxxxxx7746,,-96.62,1573.88,96.62
7/11/2020,Home loan offset - Transfer to Kiran Joy - Receipt 818435 To 032885 5310008,,-7500,1670.5,7500
7/11/2020,ANUPSPORTSS - Visa Purchase - Receipt 105299In 0435637487 Date 05 Nov 2020 Card 462263xxxxxx7746,,-70,2170.5,70
7/11/2020,WOOLWORTHS 2752 - Visa Purchase - Receipt 105298In KALLANGUR Date 04 Nov 2020 Card 462263xxxxxx7746,,-2.5,2240.5,2.5
6/11/2020,Kogan MoneyBlackCard          4813635950084279 - BPAY Bill Payment - Receipt 156346 To Kogan MoneyBlackCard 4813635950084279,,-800,2243,800
6/11/2020,International Transaction Fee - Receipt 160349,,-1.22,3041.78,1.22
6/11/2020,Patpat.com - Visa Purchase - Receipt 160349Foreign Currency Amount:  0In Dublin Date 04 Nov 2020 Card 462263xxxxxx7746,,-48.66,3043,48.66
6/11/2020,WOOLWORTHS ONLINE 8843 - Visa Purchase - Receipt 160348In BELLA VISTA Date 04 Nov 2020 Card 462263xxxxxx7746,,-39.95,3091.66,39.95
6/11/2020,WOOLWORTHS 2752 - Visa Purchase - Receipt 160347In KALLANGUR Date 04 Nov 2020 Card 462263xxxxxx7746,,-10,3131.61,10
6/11/2020,Internal Transfer - Internal Transfer - Receipt 592879  0806227416,,-100,3141.61,100
5/11/2020,Direct Debit,,-237.23,56.44,237.23
5/11/2020,International Transaction Fee - Receipt 199533,,-0.36,293.31,0.36
5/11/2020,ADOBE PHOTOGPHY PLAN - Visa Purchase - Receipt 199533Foreign Currency Amount:  0In ADOBE.LY/ENA Date 03 Nov 2020 Card 462263xxxxxx7746,,-14.29,293.67,14.29
4/11/2020,OZTIX - Visa Purchase - Receipt 167490In WOOLLOONGABB Date 01 Nov 2020 Card 462263xxxxxx7746,,-12,307.96,12
3/11/2020,BWS 2482 - Visa Purchase - Receipt 193471In GRIFFIN Date 30 Oct 2020 Card 462263xxxxxx7746,,-34,319.96,34
3/11/2020,WOOLWORTHS ONLINE 8843 - Visa Purchase - Receipt 193470In BELLA VISTA Date 31 Oct 2020 Card 462263xxxxxx7746,,-38.63,353.96,38.63
2/11/2020,Raiz Maint Fee - Direct Debit - Receipt 173917 ccac843f17ec20b022,,-2.5,392.59,2.5
2/11/2020,Water bill - BPAY Bill Payment - Receipt 797597 To UNITYWATER 0998202360,,-413.89,395.09,413.89
1/11/2020,HOUSE NORTHLAKES - Visa Purchase - Receipt 199554In NORTHLAKES Date 30 Oct 2020 Card 462263xxxxxx7746,,-31.57,308.98,31.57
1/11/2020,OFE*GRIFFINPIZZA - Visa Purchase - Receipt 199553In MOUNTWAVERLE Date 30 Oct 2020 Card 462263xxxxxx7746,,-19.5,340.55,19.5
31/10/2020,Kogan MoneyBlackCard          4813635950084279 - BPAY Bill Payment - Receipt 124012 To Kogan MoneyBlackCard 4813635950084279,,-300,360.05,300
30/10/2020,ALDI STORES - KALLANGU - Visa Purchase - Receipt 181624In KALLANGUR Date 27 Oct 2020 Card 462263xxxxxx7746,,-8.52,260.05,8.52
29/10/2020,Goodstart Murrum - Direct Debit - Receipt 152919 A005T7VT13AD,,-237.23,268.57,237.23
29/10/2020,AMZNPRIMEAU MEMBERSHIP - Visa Purchase - Receipt 108252In SYDNEY SOUTH Date 28 Oct 2020 Card 462263xxxxxx7746,,-6.99,505.8,6.99
28/10/2020,AFTERPAY - Visa Purchase - Receipt 167485In MELBOURNE Date 26 Oct 2020 Card 462263xxxxxx7746,,-4.99,512.79,4.99
28/10/2020,JAY MEDICALS PTY LTD - Visa Purchase - Receipt 167484In GRIFFIN Date 27 Oct 2020 Card 462263xxxxxx7495,,-110,517.78,110
27/10/2020,BWS LIQUOUR 2385 - Visa Purchase - Receipt 119163In KALLANGUR Date 25 Oct 2020 Card 462263xxxxxx7746,,-5,501.58,5
27/10/2020,WOOLWORTHS 2752 - Visa Purchase - Receipt 119162In KALLANGUR Date 25 Oct 2020 Card 462263xxxxxx7746,,-19.85,506.58,19.85
27/10/2020,WOOLWORTHS ONLINE 8843 - Visa Purchase - Receipt 119161In BELLA VISTA Date 24 Oct 2020 Card 462263xxxxxx7746,,-36.15,526.43,36.15
26/10/2020,Raiz Investment - Direct Debit - Receipt 119483 1f9e3dadd586cdba1a,,-20.89,562.58,20.89
26/10/2020,MICROSOFT*EA PLAY 1 MONTH - Visa Purchase - Receipt 194717In MSBILL.INFO Date 24 Oct 2020 Card 462263xxxxxx7746,,-6.99,583.47,6.99
25/10/2020,Kogan MoneyBlackCard          4813635950084279 - BPAY Bill Payment - Receipt 61695 To Kogan MoneyBlackCard 4813635950084279,,-300,590.46,300
25/10/2020,KALLANGUR GROCERS - Visa Purchase - Receipt 166622In KALLANGUR Date 23 Oct 2020 Card 462263xxxxxx7746,,-12.64,590.46,12.64
24/10/2020,CHEMIST WAREHOUSE - Visa Purchase - Receipt 107935In NORTH LAKES Date 22 Oct 2020 Card 462263xxxxxx7746,,-8.99,603.1,8.99
24/10/2020,Audible Australia - Visa Purchase - Receipt 107934In MELBOURNE Date 22 Oct 2020 Card 462263xxxxxx7746,,-16.45,612.09,16.45
24/10/2020,SQD*Little Images Clev - Visa Purchase - Receipt 107933In Thornlands Date 22 Oct 2020 Card 462263xxxxxx7746,,-38,628.54,38
23/10/2020,WOOLWORTHS 2508 - Visa Purchase - Receipt 156662In MANGO HILL Date 21 Oct 2020 Card 462263xxxxxx7746,,-37.04,666.54,37.04
22/10/2020,Goodstart Murrum - Direct Debit - Receipt 170722 A005SEQW10QA,,-237.24,703.58,237.24
22/10/2020,OPTUS BILLING - Direct Debit - Receipt 112694 62173942475,,-99,940.82,99
22/10/2020,ALDI STORES - KALLANGU - Visa Purchase - Receipt 121151In KALLANGUR Date 19 Oct 2020 Card 462263xxxxxx7746,,-28.23,1039.82,28.23
22/10/2020,AGL SALES PTY LTD - Visa Purchase - Receipt 121150In SYDNEY Date 20 Oct 2020 Card 462263xxxxxx7746,,-124.76,1068.05,124.76
21/10/2020,ALDI STORES - KALLANGU - Visa Purchase - Receipt 187437In KALLANGUR Date 18 Oct 2020 Card 462263xxxxxx7746,,-31.77,1192.81,31.77
21/10/2020,MSFT *<E0400CADJN> - Visa Purchase - Receipt 187436In MSFT AZURE Date 19 Oct 2020 Card 462263xxxxxx7746,,-2.81,1224.58,2.81
20/10/2020,WU *3179006856 - Visa Purchase - Receipt 161778In SYDNEY Date 16 Oct 2020 Card 462263xxxxxx7746,,-302.9,1227.39,302.9
20/10/2020,EB *2020 Moreton Kids - Visa Purchase - Receipt 161777In 801-413-7200 Date 17 Oct 2020 Card 462263xxxxxx7746,,-17.67,1530.29,17.67
20/10/2020,NETFLIX.COM - Visa Purchase - Receipt 161776In Melbourne Date 18 Oct 2020 Card 462263xxxxxx7746,,-13.99,1547.96,13.99
18/10/2020,Kogan MoneyBlackCard          4813635950084279 - BPAY Bill Payment - Receipt 225192 To Kogan MoneyBlackCard 4813635950084279,,-500,1561.95,500
18/10/2020,CHEMISTWAREHOUSE ONLINE - Visa Purchase - Receipt 168333In Preston Date 17 Oct 2020 Card 462263xxxxxx7495,,-52.46,2061.95,52.46
18/10/2020,Microsoft*Microsoft 365 P - Visa Purchase - Receipt 168332In msbill.info Date 16 Oct 2020 Card 462263xxxxxx7746,,-10,2114.41,10
17/10/2020,BWS 2482 - Visa Purchase - Receipt 140373In GRIFFIN Date 15 Oct 2020 Card 462263xxxxxx7746,,-5,2124.41,5
17/10/2020,All Direct debits - Transfer to Kiran Joy - Receipt 79024 To 032885 5310008,,-3100,2129.41,3100
16/10/2020,Raiz Investment - Direct Debit - Receipt 136531 1819a51f5ad12f68f5,,-21.76,5229.41,21.76
16/10/2020,Internal Transfer - Internal Transfer - Receipt 115544 Orange Everyday 0065083812,,-345,5251.17,345
16/10/2020,Internal Transfer - Internal Transfer - Receipt 210163 Savings Maximiser 0046211453,,-1180,5596.17,1180
16/10/2020,Internal Transfer - Internal Transfer - Receipt 209994 Savings Maximiser 0046211237,,-690,6776.17,690
15/10/2020,Goodstart Murrum - Direct Debit - Receipt 106125 A005RK0311SB,,-237.28,7466.17,237.28
15/10/2020,Internal Transfer - Internal Transfer - Receipt 789065  0806227416,,-50,7703.45,50
15/10/2020,CHEMIST WAREHOUSE - Visa Purchase - Receipt 106653In NORTH LAKES Date 13 Oct 2020 Card 462263xxxxxx7746,,-6,7753.45,6
15/10/2020,DISNEY PLUS - Visa Purchase - Receipt 106652In RICHMOND Date 13 Oct 2020 Card 462263xxxxxx7746,,-8.99,7759.45,8.99
15/10/2020,Vodafone Australia - Visa Purchase - Receipt 106651In North Sydney Date 13 Oct 2020 Card 462263xxxxxx7746,,-69.64,7768.44,69.64
14/10/2020,AFTERPAY - Visa Purchase - Receipt 169731In MELBOURNE Date 13 Oct 2020 Card 462263xxxxxx7746,,-4.99,180.76,4.99
14/10/2020,OXFAM AUSTRALIA Q - Visa Purchase - Receipt 169730In CARLTON Date 12 Oct 2020 Card 462263xxxxxx7746,,-55,185.75,55
13/10/2020,Kogan MoneyBlackCard          4813635950084279 - BPAY Bill Payment - Receipt 219966 To Kogan MoneyBlackCard 4813635950084279,,-141,240.75,141
13/10/2020,WOOLWORTHS 2752 - Visa Purchase - Receipt 142272In KALLANGUR Date 10 Oct 2020 Card 462263xxxxxx7746,,-15,240.75,15
13/10/2020,WOOLWORTHS 2752 - Visa Purchase - Receipt 142271In KALLANGUR Date 10 Oct 2020 Card 462263xxxxxx7746,,-1,255.75,1
12/10/2020,Kogan MoneyBlackCard          4813635950084279 - BPAY Bill Payment - Receipt 397450 To Kogan MoneyBlackCard 4813635950084279,,-800,256.75,800
10/10/2020,Kogan MoneyBlackCard          4813635950084279 - BPAY Bill Payment - Receipt 276125 To Kogan MoneyBlackCard 4813635950084279,,-200,156.75,200
9/10/2020,WOOLWORTHS 2752 - Visa Purchase - Receipt 144944In KALLANGUR Date 07 Oct 2020 Card 462263xxxxxx7746,,-5,156.75,5
8/10/2020,Goodstart Murrum - Direct Debit - Receipt 134761 A005QPCD0Y9Q,,-134.82,161.75,134.82
8/10/2020,Kogan MoneyBlackCard          4813635950084279 - BPAY Bill Payment - Receipt 68191 To Kogan MoneyBlackCard 4813635950084279,,-80,296.57,80
8/10/2020,SHAPLAND SWIM KALLAN - Visa Purchase - Receipt 121528In KALLANGUR Date 07 Oct 2020 Card 462263xxxxxx7746,,-102.5,276.57,102.5
8/10/2020,WOOLWORTHS 2508 - Visa Purchase - Receipt 121527In MANGO HILL Date 06 Oct 2020 Card 462263xxxxxx7746,,-51.51,379.07,51.51
7/10/2020,Kogan MoneyBlackCard          4813635950084279 - BPAY Bill Payment - Receipt 763752 To Kogan MoneyBlackCard 4813635950084279,,-250,430.58,250
7/10/2020,Sheenal Nand Della Kiran - Osko Payment to 484799 351207822 - Receipt 541001 ,,-55,380.58,55
7/10/2020,ANUPSPORTSS - Visa Purchase - Receipt 167373In 0435637487 Date 05 Oct 2020 Card 462263xxxxxx7746,,-70,370.58,70
6/10/2020,Sheenal Nand Della Kiran - Osko Payment to 484799 351207822 - Receipt 485577 ,,-60,340.58,60
6/10/2020,WOOLWORTHS ONLINE 8843 - Visa Purchase - Receipt 129560In BELLA VISTA Date 04 Oct 2020 Card 462263xxxxxx7746,,-47.97,400.58,47.97
5/10/2020,Raiz Investment - Direct Debit - Receipt 122625 8c11a91b79904fff36,,-20.41,448.55,20.41
5/10/2020,Kogan MoneyBlackCard          4813635950084279 - BPAY Bill Payment - Receipt 37946 To Kogan MoneyBlackCard 4813635950084279,,-50,468.96,50
5/10/2020,Kogan MoneyBlackCard          4813635950084279 - BPAY Bill Payment - Receipt 248660 To Kogan MoneyBlackCard 4813635950084279,,-50,368.96,50
5/10/2020,International Transaction Fee - Receipt 174132,,-0.36,418.6,0.36
5/10/2020,ADOBE PHOTOGPHY PLAN - Visa Purchase - Receipt 174132Foreign Currency Amount:  0In ADOBE.LY/ENA Date 03 Oct 2020 Card 462263xxxxxx7746,,-14.29,418.96,14.29
4/10/2020,Kogan MoneyBlackCard          4813635950084279 - BPAY Bill Payment - Receipt 691860 To Kogan MoneyBlackCard 4813635950084279,,-150,233.25,150
3/10/2020,ALDI STORES - KALLANGU - Visa Purchase - Receipt 115738In KALLANGUR Date 30 Sep 2020 Card 462263xxxxxx7746,,-19.05,383.25,19.05
1/10/2020,Goodstart Murrum - Direct Debit - Receipt 130327 A005PQK30XS0,,-274.3,402.3,274.3
1/10/2020,Raiz Maint Fee - Direct Debit - Receipt 191718 d396d3506c0e417a03,,-2.5,676.6,2.5
1/10/2020,BABY BUNTING PL - Visa Purchase - Receipt 183170In NORTH LAKES Date 29 Sep 2020 Card 462263xxxxxx7746,,-50.41,679.1,50.41
1/10/2020,WOOLWORTHS 2752 - Visa Purchase - Receipt 183169In KALLANGUR Date 29 Sep 2020 Card 462263xxxxxx7746,,-6,729.51,6
1/10/2020,ALDI STORES - KALLANGU - Visa Purchase - Receipt 183168In KALLANGUR Date 28 Sep 2020 Card 462263xxxxxx7746,,-19.54,735.51,19.54
30/09/2020,RADHE SPICE PTY LTD - Visa Purchase - Receipt 120244In NORTH LAKES Date 25 Sep 2020 Card 462263xxxxxx7746,,-45.39,755.05,45.39
30/09/2020,COSTCO WHOLESALE AUS - Visa Purchase - Receipt 120243In NORTH LAKES Date 28 Sep 2020 Card 462263xxxxxx7746,,-113,800.44,113
29/09/2020,AMZNPRIMEAU MEMBERSHIP - Visa Purchase - Receipt 126035In SYDNEY SOUTH Date 28 Sep 2020 Card 462263xxxxxx7746,,-6.99,913.44,6.99
28/09/2020,COSTCO FUEL NORTH LAKE NORTH LAKES - EFTPOS Purchase - Receipt 60703Date 28 Sep 2020 Time 11:29AM Card 462263xxxxxx7746,,-42.88,920.43,42.88
28/09/2020,COSTCO FUEL NORTH LAKE NORTH LAKES - EFTPOS Purchase - Receipt 60701Date 28 Sep 2020 Time 11:29AM Card 462263xxxxxx7746,,-60,903.31,60
28/09/2020,Lawnton Country Marke - Visa Purchase - Receipt 174662In Lawnton Date 27 Sep 2020 Card 462263xxxxxx7746,,-20.28,963.31,20.28
28/09/2020,AUSSIE SEAFOOD HOUSE - Visa Purchase - Receipt 174661In LAWNTON Date 27 Sep 2020 Card 462263xxxxxx7746,,-24.11,983.59,24.11
28/09/2020,eBay O*13-05791-67991 - Visa Purchase - Receipt 174660In Sydney Date 26 Sep 2020 Card 462263xxxxxx7746,,-6.45,1007.7,6.45
26/09/2020,GOURMET MEATS - Visa Purchase - Receipt 199277In MURRUMBA DOW Date 25 Sep 2020 Card 462263xxxxxx7746,,-20.5,1014.15,20.5
26/09/2020,GRIFFIN C D PHARMACY - Visa Purchase - Receipt 199276In GRIFFIN Date 25 Sep 2020 Card 462263xxxxxx7746,,-17.2,1034.65,17.2
26/09/2020,MICROSOFT*EA PLAY 1 MONTH - Visa Purchase - Receipt 199275In MSBILL.INFO Date 24 Sep 2020 Card 462263xxxxxx7746,,-6.99,1051.85,6.99
26/09/2020,WOOLWORTHS 2752 - Visa Purchase - Receipt 199274In KALLANGUR Date 24 Sep 2020 Card 462263xxxxxx7746,,-29.3,1058.84,29.3
25/09/2020,COLES 4561 MURRUMBA DW - EFTPOS Purchase - Receipt 274014Date 25 Sep 2020 Time 12:41PM Card 462263xxxxxx7746,,-23.8,1088.14,23.8
25/09/2020,SWADES FOODS TOOWONG - Visa Purchase - Receipt 139530In TOOWONG Date 22 Sep 2020 Card 462263xxxxxx7746,,-23,1111.94,23
24/09/2020,Raiz Investment - Direct Debit - Receipt 173578 fdf9877374a2833416,,-21.18,1134.94,21.18
24/09/2020,Goodstart Murrum - Direct Debit - Receipt 173577 A005NK5M0UUE,,-231.16,1156.12,231.16
24/09/2020,ALDI STORES - KALLANGU - Visa Purchase - Receipt 171432In KALLANGUR Date 21 Sep 2020 Card 462263xxxxxx7746,,-8.81,1387.28,8.81
24/09/2020,Audible Australia - Visa Purchase - Receipt 171431In MELBOURNE Date 22 Sep 2020 Card 462263xxxxxx7746,,-16.45,1396.09,16.45
23/09/2020,OPTUS BILLING - Direct Debit - Receipt 175562 62173942475,,-99,1412.54,99
23/09/2020,WOOLWORTHS ONLINE 8843 - Visa Purchase - Receipt 113866In BELLA VISTA Date 22 Sep 2020 Card 462263xxxxxx7746,,-52.21,1511.54,52.21
23/09/2020,WOOLWORTHS 2752 - Visa Purchase - Receipt 113865In KALLANGUR Date 22 Sep 2020 Card 462263xxxxxx7746,,-7.5,1563.75,7.5
23/09/2020,NETFLIX COM - Visa Purchase - Receipt 113864In MELBOURNE Date 19 Sep 2020 Card 462263xxxxxx7746,,-13.99,1571.25,13.99
23/09/2020,ALDI STORES - NORTH LA - Visa Purchase - Receipt 113863In NORTH LAKES Date 20 Sep 2020 Card 462263xxxxxx7746,,-40.15,1585.24,40.15
21/09/2020,Car loan extra - Transfer to Kiran Joy - Receipt 254963 To 032885 5310008,,-800,1625.39,800
21/09/2020,MSFT *<E0400C0BKH> - Visa Purchase - Receipt 172528In MSFT AZURE Date 19 Sep 2020 Card 462263xxxxxx7746,,-2.82,2425.39,2.82
21/09/2020,ALDI STORES - KALLANGU - Visa Purchase - Receipt 172527In KALLANGUR Date 18 Sep 2020 Card 462263xxxxxx7746,,-69.92,2428.21,69.92
20/09/2020,ALDI STORES - NORTH LA - Visa Purchase - Receipt 174272In NORTH LAKES Date 17 Sep 2020 Card 462263xxxxxx7746,,-59.66,2498.13,59.66
19/09/2020,BOMBORA SUPPLIERS - Visa Purchase - Receipt 101280In ADAMSTOWN Date 18 Sep 2020 Card 462263xxxxxx7746,,-25.95,2557.79,25.95
19/09/2020,BOMBORA SUPPLIERS - Visa Purchase - Receipt 101279In ADAMSTOWN Date 18 Sep 2020 Card 462263xxxxxx7746,,-58.9,2583.74,58.9
19/09/2020,WU 2026087071020636 - Visa Purchase - Receipt 101278In 1800173833 Date 17 Sep 2020 Card 462263xxxxxx7746,,-302.9,2642.64,302.9
19/09/2020,COSTCO FUEL NORTH LAKE - Visa Purchase - Receipt 101277In NORTH LAKES Date 17 Sep 2020 Card 462263xxxxxx7746,,-60,2945.54,60
18/09/2020,KRUGER ANZ PTY LTD - Visa Purchase - Receipt 149264In KEW Date 17 Sep 2020 Card 462263xxxxxx7746,,-25,3005.54,25
18/09/2020,MCDONALDS MURRUMBA DO - Visa Purchase - Receipt 149263In MURRUMBA DOW Date 15 Sep 2020 Card 462263xxxxxx7746,,-4,3030.54,4
18/09/2020,Microsoft*Microsoft 365 P - Visa Purchase - Receipt 149262In msbill.info Date 16 Sep 2020 Card 462263xxxxxx7746,,-10,3034.54,10
17/09/2020,Raiz Investment - Direct Debit - Receipt 111232 84a557e4ff8e2cf60a,,-28.6,3044.54,28.6
17/09/2020,Goodstart Murrum - Direct Debit - Receipt 111231 A005MMAP0W2D,,-231.16,3073.14,231.16
17/09/2020,All Direct debits - Transfer to Kiran Joy - Receipt 661131 To 032885 5310008,,-3100,3304.3,3100
17/09/2020,ChildhoodCancerSupport - Visa Purchase - Receipt 168772In 0738445000 Date 16 Sep 2020 Card 462263xxxxxx7746,,-26.61,6404.3,26.61
17/09/2020,SHAPLAND SWIM KALLAN - Visa Purchase - Receipt 168771In KALLANGUR Date 16 Sep 2020 Card 462263xxxxxx7746,,-82,6430.91,82
16/09/2020,Internal Transfer - Internal Transfer - Receipt 276734 Orange Everyday 0065083812,,-345,6512.91,345
16/09/2020,Internal Transfer - Internal Transfer - Receipt 348553 Savings Maximiser 0046211453,,-1180,6857.91,1180
16/09/2020,Internal Transfer - Internal Transfer - Receipt 347975 Savings Maximiser 0046211237,,-690,8037.91,690
16/09/2020,WOOLWORTHS ONLINE 8843 - Visa Purchase - Receipt 100542In BELLA VISTA Date 15 Sep 2020 Card 462263xxxxxx7746,,-41.3,8727.91,41.3
15/09/2020,OFFICEWORKS 0430 NORTH LAKES - EFTPOS Purchase - Receipt 30254Date 15 Sep 2020 Time 3:44PM Card 462263xxxxxx7746,,-10.09,8769.21,10.09
15/09/2020,Internal Transfer - Internal Transfer - Receipt 56421  0806227416,,-100,8779.3,100
15/09/2020,International Transaction Fee - Receipt 193542,,-1.6,8877.7,1.6
15/09/2020,Patpat.com - Visa Purchase - Receipt 193542Foreign Currency Amount:  0In Dublin Date 13 Sep 2020 Card 462263xxxxxx7746,,-64.17,8879.3,64.17
15/09/2020,GOURMET MEATS - Visa Purchase - Receipt 193541In MURRUMBA DOW Date 14 Sep 2020 Card 462263xxxxxx7746,,-43.35,8943.47,43.35
15/09/2020,DISNEY PLUS - Visa Purchase - Receipt 193540In RICHMOND Date 13 Sep 2020 Card 462263xxxxxx7746,,-8.99,8986.82,8.99
15/09/2020,NORTHSIDE INDOOR SPO - Visa Purchase - Receipt 193539In NORTH LAKES Date 12 Sep 2020 Card 462263xxxxxx7746,,-5.5,8995.81,5.5
14/09/2020,PLINE PH WESTFIELD NL  NO RTH LAKES  Q - EFTPOS Purchase - Receipt 1969Date 14 Sep 2020 Time 11:33AM Card 462263xxxxxx7746,,-28.08,1429.98,28.08
14/09/2020,IKEA NORTHLAKES NORTH LAKES - EFTPOS Purchase - Receipt 143810Date 14 Sep 2020 Time 11:21AM Card 462263xxxxxx7746,,-28,1458.06,28
14/09/2020,KMART 1228 NORTH LAKES - EFTPOS Purchase - Receipt 175352Date 14 Sep 2020 Time 11:02AM Card 462263xxxxxx7746,,-7,1486.06,7
13/09/2020,ALDI STORES - KALLANGU - Visa Purchase - Receipt 155140In KALLANGUR Date 10 Sep 2020 Card 462263xxxxxx7746,,-33.36,1493.06,33.36
13/09/2020,ASHTA LAKSHMI PTY LT - Visa Purchase - Receipt 155139In BURPENGARY Date 11 Sep 2020 Card 462263xxxxxx7746,,-49.75,1526.42,49.75
13/09/2020,BRIGHT SHADOW TRADIN - Visa Purchase - Receipt 155138In GRIFFIN Date 11 Sep 2020 Card 462263xxxxxx7746,,-13,1576.17,13
12/09/2020,OXFAM AUSTRALIA Q - Visa Purchase - Receipt 168811In CARLTON Date 10 Sep 2020 Card 462263xxxxxx7746,,-55,1589.17,55
12/09/2020,VODAFONE - Visa Purchase - Receipt 168810In NORTH SYDNEY Date 10 Sep 2020 Card 462263xxxxxx7746,,-84.59,1644.17,84.59
11/09/2020,KMART 1254 BURPENGARY - EFTPOS Purchase - Receipt 349888Date 11 Sep 2020 Time 7:13PM Card 462263xxxxxx7746,,-47.5,1728.76,47.5
10/09/2020,Goodstart Murrum - Direct Debit - Receipt 146255 A005LSSG0UA3,,-230.61,1776.26,230.61
10/09/2020,CHEMIST WAREHOUSE - Visa Purchase - Receipt 186540In NORTH LAKES Date 08 Sep 2020 Card 462263xxxxxx7746,,-46.17,2006.87,46.17
10/09/2020,GRIFFIN PIZZA - Visa Purchase - Receipt 186539In GRIFFIN Date 08 Sep 2020 Card 462263xxxxxx7746,,-25.5,2053.04,25.5
10/09/2020,ALIEXPRESS.COM - Visa Purchase - Receipt 186538In Melbourne Date 08 Sep 2020 Card 462263xxxxxx7746,,-26.82,2078.54,26.82
10/09/2020,GRIFFIN MEDICAL CENT - Visa Purchase - Receipt 186537In GRIFFIN Date 08 Sep 2020 Card 462263xxxxxx7495,,-110,2105.36,110
10/09/2020,Internal Transfer - Internal Transfer - Receipt 244626  0806227416,,-150,2215.36,150
9/09/2020,Raiz Investment - Direct Debit - Receipt 110144 2c875fdaad7e118ea0,,-20.35,367.29,20.35
9/09/2020,LeBonChoixNorthLakes - Visa Purchase - Receipt 100542In North Lakes Date 08 Sep 2020 Card 462263xxxxxx7746,,-12.73,387.64,12.73
9/09/2020,WOOLWORTHS ONLINE 8843 - Visa Purchase - Receipt 100541In BELLA VISTA Date 08 Sep 2020 Card 462263xxxxxx7746,,-42.41,400.37,42.41
9/09/2020,MCDONALDS KALLANGUR - Visa Purchase - Receipt 100540In KALLANGUR Date 04 Sep 2020 Card 462263xxxxxx7746,,-11.2,442.78,11.2
9/09/2020,BUNNINGS 376000 - Visa Purchase - Receipt 100539In NORTH LAKES Date 06 Sep 2020 Card 462263xxxxxx7746,,-41.15,453.98,41.15
8/09/2020,GOURMET MEATS - Visa Purchase - Receipt 192282In MURRUMBA DOW Date 06 Sep 2020 Card 462263xxxxxx7746,,-30.4,207.68,30.4
8/09/2020,7-ELEVEN 4266 - Visa Purchase - Receipt 192281In GRIFFIN Date 05 Sep 2020 Card 462263xxxxxx7746,,-5,238.08,5
8/09/2020,7-ELEVEN 4266 - Visa Purchase - Receipt 192280In GRIFFIN Date 05 Sep 2020 Card 462263xxxxxx7746,,-0.8,243.08,0.8
8/09/2020,BWS 2482 - Visa Purchase - Receipt 192279In GRIFFIN Date 05 Sep 2020 Card 462263xxxxxx7746,,-18,243.88,18
8/09/2020,BUNNINGS 376000 - Visa Purchase - Receipt 192278In NORTH LAKES Date 05 Sep 2020 Card 462263xxxxxx7746,,-44.08,261.88,44.08
8/09/2020,ALDI STORES - NORTH LA - Visa Purchase - Receipt 192277In NORTH LAKES Date 05 Sep 2020 Card 462263xxxxxx7746,,-37.85,305.96,37.85
8/09/2020,Kogan MoneyBlackCard          4813635950084279 - BPAY Bill Payment - Receipt 740967 To Kogan MoneyBlackCard 4813635950084279,,-35,343.81,35
7/09/2020,ALDI STORES - NORTH LA - Visa Purchase - Receipt 129435In NORTH LAKES Date 04 Sep 2020 Card 462263xxxxxx7746,,-92.42,313.81,92.42
7/09/2020,ANUPSPORTSS - Visa Purchase - Receipt 129434In 0435637487 Date 05 Sep 2020 Card 462263xxxxxx7746,,-120,406.23,120
7/09/2020,COLES 4561 - Visa Purchase - Receipt 129433In MURRUMBA DWN Date 06 Sep 2020 Card 462263xxxxxx7746,,-7.5,526.23,7.5
6/09/2020,BUNNINGS 376000 - Visa Purchase - Receipt 193591In NORTH LAKES Date 03 Sep 2020 Card 462263xxxxxx7746,,-26,433.73,26
5/09/2020,International Transaction Fee - Receipt 186265,,-0.36,239.37,0.36
5/09/2020,ADOBE PHOTOGPHY PLAN - Visa Purchase - Receipt 186265Foreign Currency Amount:  0In ADOBE.LY/ENA Date 03 Sep 2020 Card 462263xxxxxx7746,,-14.29,239.73,14.29
5/09/2020,ALDI STORES - KALLANGU - Visa Purchase - Receipt 186264In KALLANGUR Date 02 Sep 2020 Card 462263xxxxxx7746,,-8.32,254.02,8.32
5/09/2020,ALDI STORES - KALLANGU - Visa Purchase - Receipt 186263In KALLANGUR Date 02 Sep 2020 Card 462263xxxxxx7746,,-8.19,262.34,8.19
5/09/2020,SWADES FOODS TOOWONG - Visa Purchase - Receipt 186262In TOOWONG Date 02 Sep 2020 Card 462263xxxxxx7746,,-20,270.53,20
4/09/2020,KMART ONLINE - Visa Purchase - Receipt 100386In 03 Date 03 Sep 2020 Card 462263xxxxxx7746,,-55,190.53,55
4/09/2020,POST KALLANGUR LPO  KA - Visa Purchase - Receipt 100385In KALLANGUR Date 02 Sep 2020 Card 462263xxxxxx7746,,-18.95,245.53,18.95
4/09/2020,BCC ON-STREET PARKING - Visa Purchase - Receipt 100384In BRISBANE Date 02 Sep 2020 Card 462263xxxxxx7746,,-4,264.48,4
4/09/2020,BUNNINGS 376000 - Visa Purchase - Receipt 100383In NORTH LAKES Date 01 Sep 2020 Card 462263xxxxxx7746,,-25.5,268.48,25.5
4/09/2020,OP STORECO PTY LTD - Visa Purchase - Receipt 100382In MANGO HILL Date 01 Sep 2020 Card 462263xxxxxx7746,,-38.45,293.98,38.45
4/09/2020,SWADES FOODS ASPLEY - Visa Purchase - Receipt 100381In ASPLEY Date 02 Sep 2020 Card 462263xxxxxx7746,,-87.69,332.43,87.69
3/09/2020,Raiz Investment - Direct Debit - Receipt 139081 588b8baead26b40c65,,-21.43,420.12,21.43
3/09/2020,Goodstart Murrum - Direct Debit - Receipt 139080 A005KUNK0VE8,,-52,441.55,52
3/09/2020,Goodstart Murrum - Direct Debit - Receipt 139079 A005KUNK0VE7,,-298.77,493.55,298.77
3/09/2020,ROCKS CAFE AND BOATHIR - Visa Purchase - Receipt 144793In GRIFFIN Date 01 Sep 2020 Card 462263xxxxxx7746,,-14,792.32,14
3/09/2020,ALDI STORES - NORTH LA - Visa Purchase - Receipt 144792In NORTH LAKES Date 31 Aug 2020 Card 462263xxxxxx7746,,-18.85,806.32,18.85
2/09/2020,VFS SERVICES AUSTRAL SPRING HILL - EFTPOS Purchase - Receipt 2308Date 02 Sep 2020 Time 11:57AM Card 462263xxxxxx7746,,-182.48,425.17,182.48
2/09/2020,LIVING FAITH LUTHERA - Visa Purchase - Receipt 182027In MURRUMBA DOW Date 31 Aug 2020 Card 462263xxxxxx7746,,-104,607.65,104
2/09/2020,WOOLWORTHS ONLINE 8843 - Visa Purchase - Receipt 182026In BELLA VISTA Date 31 Aug 2020 Card 462263xxxxxx7746,,-55.66,711.65,55.66
1/09/2020,COSTCO FUEL NORTH LAKE NORTH LAKES - EFTPOS Purchase - Receipt 84135Date 01 Sep 2020 Time 6:23PM Card 462263xxxxxx7746,,-58.11,767.31,58.11
1/09/2020,COSTCO FUEL NORTH LAKE NORTH LAKES - EFTPOS Purchase - Receipt 84133Date 01 Sep 2020 Time 6:23PM Card 462263xxxxxx7746,,-60,765.42,60
1/09/2020,Raiz Maint Fee - Direct Debit - Receipt 168644 56e16be5f59582693a,,-2.5,525.42,2.5
1/09/2020,Lawnton Country Marke - Visa Purchase - Receipt 118199In Lawnton Date 31 Aug 2020 Card 462263xxxxxx7495,,-33.53,527.92,33.53
1/09/2020,AUSSIE SEAFOOD HOUSE - Visa Purchase - Receipt 118198In LAWNTON Date 31 Aug 2020 Card 462263xxxxxx7495,,-26.15,561.45,26.15
1/09/2020,Warburton Butcher LT - Visa Purchase - Receipt 118197In Lawnton Date 31 Aug 2020 Card 462263xxxxxx7495,,-22.79,587.6,22.79
29/08/2020,IKEA NORTHLAKES NORTH LAKES - EFTPOS Purchase - Receipt 206235Date 29 Aug 2020 Time 1:03PM Card 462263xxxxxx7746,,-289.29,410.39,289.29
29/08/2020,AMZNPRIMEAU MEMBERSHIP - Visa Purchase - Receipt 148558In SYDNEY SOUTH Date 28 Aug 2020 Card 462263xxxxxx7746,,-6.99,699.68,6.99
29/08/2020,WOOLWORTHS 2752 - Visa Purchase - Receipt 148557In KALLANGUR Date 27 Aug 2020 Card 462263xxxxxx7746,,-48.98,706.67,48.98
29/08/2020,LINKT BRISBANE - Visa Purchase - Receipt 148556In BRISBANE Date 26 Aug 2020 Card 462263xxxxxx7746,,-25.08,755.65,25.08
28/08/2020,CHEMIST WAREHOUSE - Visa Purchase - Receipt 153728In NORTH LAKES Date 26 Aug 2020 Card 462263xxxxxx7495,,-24.44,780.73,24.44
28/08/2020,HOGS BREATH NORTHLAK - Visa Purchase - Receipt 153727In MANGO HILL Date 25 Aug 2020 Card 462263xxxxxx7746,,-81.8,805.17,81.8
28/08/2020,BEST AND LESS - Visa Purchase - Receipt 153726In MANGO HILL Date 26 Aug 2020 Card 462263xxxxxx7495,,-59,886.97,59
27/08/2020,Goodstart Murrum - Direct Debit - Receipt 151494 A005HPKC0TW5,,-240,645.97,240
27/08/2020,International Transaction Fee - Receipt 197612,,-1.46,684.51,1.46
27/08/2020,PAYPAL *PRIVATEINTE - Visa Purchase - Receipt 197612Foreign Currency Amount:  0In 4029357733 Date 25 Aug 2020 Card 462263xxxxxx7746,,-58.2,685.97,58.2
27/08/2020,COLES 4545 - Visa Purchase - Receipt 197611In NORTH LAKE Date 26 Aug 2020 Card 462263xxxxxx7746,,-7.5,744.17,7.5
27/08/2020,AFTERPAY - Visa Purchase - Receipt 197610In MELBOURNE Date 25 Aug 2020 Card 462263xxxxxx7746,,-38.98,751.67,38.98
27/08/2020,GOURMET MEATS - Visa Purchase - Receipt 197609In MURRUMBA DOW Date 25 Aug 2020 Card 462263xxxxxx7746,,-17.75,790.65,17.75
27/08/2020,COMPASS LCCH - Visa Purchase - Receipt 197608In SOUTH BRISBA Date 24 Aug 2020 Card 462263xxxxxx7495,,-10.89,808.4,10.89
26/08/2020,Raiz Investment - Direct Debit - Receipt 173245 0c1c8a5b0507cb82ac,,-20.88,819.29,20.88
26/08/2020,TARGET 5167 NORTH LAKES - EFTPOS Purchase - Receipt 139257Date 26 Aug 2020 Time 11:47AM Card 462263xxxxxx7495,,-30,840.17,30
26/08/2020,SP * MAMACLOTHING - Visa Purchase - Receipt 165343In POINT COOK Date 24 Aug 2020 Card 462263xxxxxx7746,,-88,370.17,88
26/08/2020,TRANSLINK - Visa Purchase - Receipt 165342In BRISBANE Date 24 Aug 2020 Card 462263xxxxxx7746,,-20,458.17,20
26/08/2020,ALDI STORES - KALLANGU - Visa Purchase - Receipt 165341In KALLANGUR Date 23 Aug 2020 Card 462263xxxxxx7746,,-26.11,478.17,26.11
26/08/2020,Microsoft*EA Play 1 Month - Visa Purchase - Receipt 165340In msbill.info Date 24 Aug 2020 Card 462263xxxxxx7746,,-6.99,504.28,6.99
26/08/2020,MCDONALDS MURRUMBA DO - Visa Purchase - Receipt 165339In MURRUMBA DOW Date 23 Aug 2020 Card 462263xxxxxx7746,,-4.4,511.27,4.4
25/08/2020,COLES 4561 MURRUMBA DW - EFTPOS Purchase - Receipt 437697Date 25 Aug 2020 Time 5:10PM Card 462263xxxxxx7746,,-21.25,515.67,21.25
25/08/2020,SQ *BROW N LASH EXPRES - Visa Purchase - Receipt 103591In Griffin Date 23 Aug 2020 Card 462263xxxxxx7495,,-15,536.92,15
25/08/2020,GOURMET MEATS - Visa Purchase - Receipt 103590In MURRUMBA DOW Date 22 Aug 2020 Card 462263xxxxxx7746,,-23.95,551.92,23.95
25/08/2020,ALDI STORES - NORTH LA - Visa Purchase - Receipt 103589In NORTH LAKES Date 22 Aug 2020 Card 462263xxxxxx7746,,-10.21,575.87,10.21
24/08/2020,Audible Australia - Visa Purchase - Receipt 104125In MELBOURNE Date 22 Aug 2020 Card 462263xxxxxx7746,,-16.45,586.08,16.45
22/08/2020,1ST CHOICE 7227 MANGO HILL - EFTPOS Purchase - Receipt 118696Date 22 Aug 2020 Time 5:39PM Card 462263xxxxxx7746,,-9,602.53,9
22/08/2020,H&M Brisbane AU0016 Gympie Rd - EFTPOS Purchase - Receipt 476654Date 22 Aug 2020 Time 2:37PM Card 462263xxxxxx7495,,-116.94,611.53,116.94
22/08/2020,COSTCO FUEL NORTH LAKE NORTH LAKES - EFTPOS Purchase - Receipt 45330Date 22 Aug 2020 Time 11:09AM Card 462263xxxxxx7746,,-65.8,728.47,65.8
22/08/2020,COSTCO FUEL NORTH LAKE NORTH LAKES - EFTPOS Purchase - Receipt 45328Date 22 Aug 2020 Time 11:09AM Card 462263xxxxxx7746,,-70,724.27,70
22/08/2020,WOOLWORTHS 2752 - Visa Purchase - Receipt 144919In KALLANGUR Date 20 Aug 2020 Card 462263xxxxxx7746,,-43,794.27,43
22/08/2020,ALDI STORES - KALLANGU - Visa Purchase - Receipt 144918In KALLANGUR Date 19 Aug 2020 Card 462263xxxxxx7746,,-30.08,837.27,30.08
22/08/2020,BUNNINGS 376000 - Visa Purchase - Receipt 144917In NORTH LAKES Date 19 Aug 2020 Card 462263xxxxxx7746,,-1.91,867.35,1.91
21/08/2020,OPTUS BILLING - Direct Debit - Receipt 159154 62173942475,,-99,369.26,99
21/08/2020,MSFT *<E0400BQEX6> - Visa Purchase - Receipt 159325In MSFT AZURE Date 19 Aug 2020 Card 462263xxxxxx7746,,-2.84,468.26,2.84
21/08/2020,NETFLIX COM - Visa Purchase - Receipt 159324In MELBOURNE Date 19 Aug 2020 Card 462263xxxxxx7746,,-13.99,471.1,13.99
21/08/2020,VODAFONE - Visa Purchase - Receipt 159323In NORTH SYDNEY Date 19 Aug 2020 Card 462263xxxxxx7746,,-69.59,485.09,69.59
20/08/2020,Goodstart Murrum - Direct Debit - Receipt 112678 A005GUL30UH9,,-240,554.68,240
20/08/2020,DEBITSSUCESSDF - Direct Debit - Receipt 112677 A005GUL30UHA,,-8.25,794.68,8.25
20/08/2020,BABY BUNTING PL - Visa Purchase - Receipt 186310In NORTH LAKES Date 17 Aug 2020 Card 462263xxxxxx7746,,-246.96,802.93,246.96
19/08/2020,Raiz Investment - Direct Debit - Receipt 110467 94ceb8c734631e9d2d,,-22.36,1049.89,22.36
19/08/2020,WOOLWORTHS ONLINE 8843 - Visa Purchase - Receipt 183440In BELLA VISTA Date 17 Aug 2020 Card 462263xxxxxx7746,,-34.05,771.25,34.05
19/08/2020,SPENDLESS SHOES - Visa Purchase - Receipt 183439In MANGO HILL Date 14 Aug 2020 Card 462263xxxxxx7746,,-39.99,805.3,39.99
19/08/2020,PIZZA HUT MANGO HILL - Visa Purchase - Receipt 183438In MANGO HILL Date 15 Aug 2020 Card 462263xxxxxx7746,,-26.9,845.29,26.9
19/08/2020,GOURMET MEATS - Visa Purchase - Receipt 183437In MURRUMBA DOW Date 17 Aug 2020 Card 462263xxxxxx7746,,-38.15,872.19,38.15
19/08/2020,WOOLWORTHS 2752 - Visa Purchase - Receipt 183436In KALLANGUR Date 17 Aug 2020 Card 462263xxxxxx7746,,-11.48,910.34,11.48
18/08/2020,CHEMIST WAREHOUSE - Visa Purchase - Receipt 119334In NORTH LAKES Date 14 Aug 2020 Card 462263xxxxxx7746,,-26.57,921.82,26.57
18/08/2020,MICROSOFT*MICROSOFT 365 P - Visa Purchase - Receipt 119333In MSBILL.INFO Date 15 Aug 2020 Card 462263xxxxxx7746,,-10,948.39,10
18/08/2020,WU *4579211520 - Visa Purchase - Receipt 119332In SYDNEY Date 15 Aug 2020 Card 462263xxxxxx7746,,-302.9,958.39,302.9
18/08/2020,ALDI STORES - KALLANGU - Visa Purchase - Receipt 119331In KALLANGUR Date 15 Aug 2020 Card 462263xxxxxx7746,,-12.33,1261.29,12.33
17/08/2020,LEASE PAY - Direct Debit - Receipt 113867 001-1347737-001,,-861,1273.62,861
17/08/2020,Goodstart Murrum - Direct Debit - Receipt 132580 A005GCVF0KXF,,-112.12,2134.62,112.12
17/08/2020,All Direct debits - Transfer to Kiran Joy - Receipt 813284 To 032885 5310008,,-3100,2246.74,3100
16/08/2020,PLINE PH BRIBIE ISLAN  BE LLARA      Q - EFTPOS Purchase - Receipt 92124Date 16 Aug 2020 Time 11:55AM Card 462263xxxxxx7746,,-16.49,5346.74,16.49
16/08/2020,COSTCO FUEL NORTH LAKE - Visa Purchase - Receipt 133879In NORTH LAKES Date 14 Aug 2020 Card 462263xxxxxx7746,,-60,5187.24,60
16/08/2020,BWS 2482 - Visa Purchase - Receipt 133878In GRIFFIN Date 14 Aug 2020 Card 462263xxxxxx7746,,-74,5247.24,74
16/08/2020,MCDONALDS NORTH LAKES - Visa Purchase - Receipt 133877In NORTH LAKES Date 13 Aug 2020 Card 462263xxxxxx7746,,-4.1,5321.24,4.1
16/08/2020,BIG W 0246 - Visa Purchase - Receipt 133876In NORTHLAKES Date 14 Aug 2020 Card 462263xxxxxx7746,,-72,5325.34,72
16/08/2020,BIG W 0246 - Visa Purchase - Receipt 133875In NORTHLAKES Date 14 Aug 2020 Card 462263xxxxxx7746,,-2.35,5397.34,2.35
16/08/2020,Internal Transfer - Internal Transfer - Receipt 784786  0806227416,,-50,5399.69,50
16/08/2020,Internal Transfer - Internal Transfer - Receipt 650391 Savings Maximiser 0046211453,,-1180,5449.69,1180
16/08/2020,Internal Transfer - Internal Transfer - Receipt 650206 Savings Maximiser 0046211237,,-690,6629.69,690
16/08/2020,Kogan MoneyBlackCard          4813635950084279 - BPAY Bill Payment - Receipt 604242 To Kogan MoneyBlackCard 4813635950084279,,-150,7319.69,150
16/08/2020,Internal Transfer - Internal Transfer - Receipt 584656 Orange Everyday 0065083812,,-345,7469.69,345
15/08/2020,Ollie's Place - Visa Purchase - Receipt 121391In North Lakes Date 14 Aug 2020 Card 462263xxxxxx7746,,-12.99,7814.69,12.99
15/08/2020,DISNEY PLUS - Visa Purchase - Receipt 121390In RICHMOND Date 13 Aug 2020 Card 462263xxxxxx7746,,-8.99,7827.68,8.99
15/08/2020,RACQ EIGHT MILE PLAIN - Visa Purchase - Receipt 121389In EIGHT MILE P Date 13 Aug 2020 Card 462263xxxxxx7746,,-99,7836.67,99
14/08/2020,Raiz Investment - Direct Debit - Receipt 144324 a75c642caa4dbfb18c,,-20.89,7935.67,20.89
14/08/2020,TRANSLINK - Visa Purchase - Receipt 133668In BRISBANE Date 12 Aug 2020 Card 462263xxxxxx7746,,-20,490.23,20
13/08/2020,Direct Debit,,-240,-29.77,240
13/08/2020,DEBITSSUCESSDF - Direct Debit - Receipt 156902 A005G2G60U2A,,-8.25,210.23,8.25
13/08/2020,AFTERPAY - Visa Purchase - Receipt 165554In MELBOURNE Date 11 Aug 2020 Card 462263xxxxxx7746,,-38.98,218.48,38.98
13/08/2020,GRIFFIN C D PHARMACY - Visa Purchase - Receipt 165553In GRIFFIN Date 12 Aug 2020 Card 462263xxxxxx7746,,-12.49,257.46,12.49
13/08/2020,OXFAM AUSTRALIA Q - Visa Purchase - Receipt 165552In CARLTON Date 11 Aug 2020 Card 462263xxxxxx7746,,-50,269.95,50
12/08/2020,SUBWAY MURRUMBA DOWNS - Visa Purchase - Receipt 137964In MURRUMBA DOW Date 10 Aug 2020 Card 462263xxxxxx7746,,-15.45,319.95,15.45
12/08/2020,ROCKS CAFE AND BOATHIR - Visa Purchase - Receipt 137963In GRIFFIN Date 10 Aug 2020 Card 462263xxxxxx7746,,-12,335.4,12
12/08/2020,LINKT BRISBANE - Visa Purchase - Receipt 137962In BRISBANE Date 10 Aug 2020 Card 462263xxxxxx7746,,-25.08,347.4,25.08
12/08/2020,WOOLWORTHS 2752 - Visa Purchase - Receipt 137961In KALLANGUR Date 10 Aug 2020 Card 462263xxxxxx7746,,-64.95,372.48,64.95
12/08/2020,WOOLWORTHS 2752 - Visa Purchase - Receipt 137960In KALLANGUR Date 10 Aug 2020 Card 462263xxxxxx7746,,-14.81,437.43,14.81
12/08/2020,MCDONALDS KALLANGUR - Visa Purchase - Receipt 137959In KALLANGUR Date 07 Aug 2020 Card 462263xxxxxx7746,,-26,452.24,26
11/08/2020,International Transaction Fee - Receipt 158569,,-4.4,408.84,4.4
11/08/2020,YUPPTV USA INC. - Visa Purchase - Receipt 158569Foreign Currency Amount:  0In HTTPSWWW.YUP Date 09 Aug 2020 Card 462263xxxxxx7746,,-175.99,413.24,175.99
11/08/2020,SHAPLAND SWIM KALLAN - Visa Purchase - Receipt 158568In KALLANGUR Date 10 Aug 2020 Card 462263xxxxxx7746,,-102.5,589.23,102.5
11/08/2020,NOOSANTHSHORERETREAT - Visa Purchase - Receipt 158567In NOOSA NORTH Date 08 Aug 2020 Card 462263xxxxxx7746,,-5.2,691.73,5.2
11/08/2020,NOOSANTHSHORERETREAT - Visa Purchase - Receipt 158566In NOOSA NORTH Date 08 Aug 2020 Card 462263xxxxxx7746,,-3.5,696.93,3.5
11/08/2020,NOOSANTHSHORERETREAT - Visa Purchase - Receipt 158565In NOOSA NORTH Date 08 Aug 2020 Card 462263xxxxxx7746,,-13.5,700.43,13.5
11/08/2020,NOOSANTHSHORERETREAT - Visa Purchase - Receipt 158564In NOOSA NORTH Date 08 Aug 2020 Card 462263xxxxxx7746,,-23,713.93,23
11/08/2020,NOOSANTHSHORERETREAT - Visa Purchase - Receipt 158563In NOOSA NORTH Date 08 Aug 2020 Card 462263xxxxxx7746,,-17,736.93,17
11/08/2020,NOOSANTHSHORERETREAT - Visa Purchase - Receipt 158562In NOOSA NORTH Date 08 Aug 2020 Card 462263xxxxxx7746,,-9,753.93,9
11/08/2020,NOOSANTHSHORERETREAT - Visa Purchase - Receipt 158561In NOOSA NORTH Date 08 Aug 2020 Card 462263xxxxxx7746,,-9,762.93,9
11/08/2020,GLORIA J CABOOLTURE - Visa Purchase - Receipt 158560In CABOOLTURE Date 07 Aug 2020 Card 462263xxxxxx7495,,-5.5,771.93,5.5
11/08/2020,BALTI STRATHPINE PTY - Visa Purchase - Receipt 158559In STRATHPINE Date 09 Aug 2020 Card 462263xxxxxx7746,,-25,777.43,25
11/08/2020,WOOLWORTHS 2703 - Visa Purchase - Receipt 158558In TEWANTIN Date 09 Aug 2020 Card 462263xxxxxx7746,,-5.1,802.43,5.1
11/08/2020,WOOLWORTHS 2752 - Visa Purchase - Receipt 158557In KALLANGUR Date 07 Aug 2020 Card 462263xxxxxx7746,,-43.62,807.53,43.62
11/08/2020,COLLINS FOODS SUBSID - Visa Purchase - Receipt 158556In NORTH LAKES Date 07 Aug 2020 Card 462263xxxxxx7746,,-7.95,851.15,7.95
10/08/2020,Raiz Investment - Direct Debit - Receipt 119645 3834a6e4f7694f0279,,-20.55,659.1,20.55
10/08/2020,Reiner From Kiran - Osko Payment to 034115 166620 - Receipt 222073 ,,-350,579.65,350
9/08/2020,ALDI STORES - KALLANGU - Visa Purchase - Receipt 150072In KALLANGUR Date 06 Aug 2020 Card 462263xxxxxx7746,,-17.43,379.65,17.43
9/08/2020,COSTCO FUEL NORTH LAKE - Visa Purchase - Receipt 150071In NORTH LAKES Date 07 Aug 2020 Card 462263xxxxxx7746,,-59.59,397.08,59.59
9/08/2020,ALDI STORES - NORTH LA - Visa Purchase - Receipt 150070In NORTH LAKES Date 06 Aug 2020 Card 462263xxxxxx7746,,-0.99,456.67,0.99
9/08/2020,BRIGHT SHADOW TRADIN - Visa Purchase - Receipt 150069In GRIFFIN Date 07 Aug 2020 Card 462263xxxxxx7746,,-5,457.66,5
8/08/2020,ATM Balance Enquiry - Receipt 751531ATM owner fee of -$2.50 charged by NOOSA NORTH SHORE NOOSA SHODate 08 Aug 2020 Time 2:13PM Card 462263xxxxxx7746,,-2.5,280.16,2.5
7/08/2020,rediATM 1473 Anzac Ave Ka llangur    0 - Receipt 663ATM owner fee of $2.50 charged by rediATM 1473 Anzac Ave Ka llangur    0Date 07 Aug 2020 Time 7:21PM Card 462263xxxxxx7746,,-82.5,280.16,82.5
7/08/2020,TRANSLINK - Visa Purchase - Receipt 155300In BRISBANE Date 05 Aug 2020 Card 462263xxxxxx7746,,-20,62.66,20
7/08/2020,ALDI STORES - KALLANGU - Visa Purchase - Receipt 155299In KALLANGUR Date 04 Aug 2020 Card 462263xxxxxx7746,,-7.34,82.66,7.34
7/08/2020,SOMERVILLE HOUSE - Visa Purchase - Receipt 155298In SOUTH BRISBA Date 05 Aug 2020 Card 462263xxxxxx7495,,-4.05,90,4.05
6/08/2020,Direct Debit,,-178.87,-84.82,178.87
6/08/2020,DEBITSSUCESSDF - Direct Debit - Receipt 129555 A005F7U80V75,,-8.25,94.05,8.25
6/08/2020,ALDI STORES - NORTH LA - Visa Purchase - Receipt 127733In NORTH LAKES Date 03 Aug 2020 Card 462263xxxxxx7746,,-37.61,102.3,37.61
6/08/2020,GOURMET MEATS - Visa Purchase - Receipt 127732In MURRUMBA DOW Date 04 Aug 2020 Card 462263xxxxxx7746,,-19.75,139.91,19.75
6/08/2020,AZMAN HAROON - Visa Purchase - Receipt 127731In NORTH LAKES Date 03 Aug 2020 Card 462263xxxxxx7746,,-100.34,159.66,100.34
5/08/2020,International Transaction Fee - Receipt 104020,,-0.36,259.64,0.36
5/08/2020,ADOBE PHOTOGPHY PLAN - Visa Purchase - Receipt 104020Foreign Currency Amount:  0In ADOBE.LY/ENA Date 03 Aug 2020 Card 462263xxxxxx7746,,-14.29,260,14.29
5/08/2020,TRANSLINK - Visa Purchase - Receipt 104019In BRISBANE Date 03 Aug 2020 Card 462263xxxxxx7746,,-40,274.29,40
5/08/2020,INDIAN SPICE SHOP - Visa Purchase - Receipt 104018In ASPLEY Date 01 Aug 2020 Card 462263xxxxxx7746,,-85.11,314.29,85.11
4/08/2020,GLORIA J CABOOLTURE - Visa Purchase - Receipt 180004In CABOOLTURE Date 31 Jul 2020 Card 462263xxxxxx7495,,-8.9,299.4,8.9
4/08/2020,BWS 2482 - Visa Purchase - Receipt 180003In GRIFFIN Date 01 Aug 2020 Card 462263xxxxxx7746,,-19,308.3,19
4/08/2020,WOOLWORTHS ONLINE 8843 - Visa Purchase - Receipt 180002In BELLA VISTA Date 02 Aug 2020 Card 462263xxxxxx7746,,-31.6,327.3,31.6
4/08/2020,WOOLWORTHS 2752 - Visa Purchase - Receipt 180001In KALLANGUR Date 02 Aug 2020 Card 462263xxxxxx7746,,-12.75,358.9,12.75
3/08/2020,Raiz Maint Fee - Direct Debit - Receipt 123592 2ccc25756c27cd7d25,,-2.5,371.65,2.5
2/08/2020,SQ *MR AMERICA FOOD TR - Visa Purchase - Receipt 100881In Griffin Date 31 Jul 2020 Card 462263xxxxxx7746,,-8,174.15,8
2/08/2020,BRIGHT SHADOW TRADIN - Visa Purchase - Receipt 100880In GRIFFIN Date 31 Jul 2020 Card 462263xxxxxx7746,,-5.5,182.15,5.5
2/08/2020,COMPASS LCCH - Visa Purchase - Receipt 100879In SOUTH BRISBA Date 30 Jul 2020 Card 462263xxxxxx7495,,-5.34,187.65,5.34
2/08/2020,KEBAB HAVEN CABOOLTU - Visa Purchase - Receipt 100878In CABOOLTURE Date 31 Jul 2020 Card 462263xxxxxx7495,,-9.4,192.99,9.4
2/08/2020,GUZMAN Y GOMEZ - Visa Purchase - Receipt 100877In SURRY HILLS Date 31 Jul 2020 Card 462263xxxxxx7495,,-9.9,202.39,9.9
1/08/2020,COLES 4561 MURRUMBA DW - EFTPOS Purchase - Receipt 418345Date 01 Aug 2020 Time 6:48PM Card 462263xxxxxx7746,,-12.61,212.29,12.61
1/08/2020,WOOLWORTHS 2752 - Visa Purchase - Receipt 193768In KALLANGUR Date 30 Jul 2020 Card 462263xxxxxx7746,,-38.03,224.9,38.03
31/07/2020,Goodstart Murrum - Direct Debit - Receipt 130705 A005EK8616U6,,-232,262.93,232
31/07/2020,Raiz Investment - Direct Debit - Receipt 130704 89922e0b815ec0924e,,-21.7,494.93,21.7
31/07/2020,AFTERPAY - Visa Purchase - Receipt 161274In MELBOURNE Date 29 Jul 2020 Card 462263xxxxxx7746,,-38.98,516.63,38.98
31/07/2020,TRANSLINK - Visa Purchase - Receipt 161273In BRISBANE Date 29 Jul 2020 Card 462263xxxxxx7746,,-20,555.61,20
31/07/2020,RED DOG PETROLEUM - Visa Purchase - Receipt 161272In KALLANGUR Date 29 Jul 2020 Card 462263xxxxxx7746,,-68.42,575.61,68.42
30/07/2020,Direct Debit,,-231.16,112.87,231.16
30/07/2020,ALDI STORES - KALLANGU - Visa Purchase - Receipt 194752In KALLANGUR Date 27 Jul 2020 Card 462263xxxxxx7746,,-15.17,144.03,15.17
30/07/2020,PEE MAI THAI - Visa Purchase - Receipt 194751In REDCLIFFE Date 27 Jul 2020 Card 462263xxxxxx7746,,-25.8,159.2,25.8
29/07/2020,TARGET 5172 STRATHPINE - EFTPOS Purchase - Receipt 198484Date 29 Jul 2020 Time 11:54AM Card 462263xxxxxx7746,,-59,185,59
29/07/2020,AMZNPRIMEAU MEMBERSHIP - Visa Purchase - Receipt 105236In SYDNEY SOUTH Date 28 Jul 2020 Card 462263xxxxxx7746,,-6.99,244,6.99
28/07/2020,GOURMET MEATS - Visa Purchase - Receipt 112193In MURRUMBA DOW Date 27 Jul 2020 Card 462263xxxxxx7746,,-26,50.99,26
28/07/2020,GLORIA J CABOOLTURE - Visa Purchase - Receipt 112192In CABOOLTURE Date 24 Jul 2020 Card 462263xxxxxx7495,,-8.9,76.99,8.9
28/07/2020,BWS LIQUOUR 2385 - Visa Purchase - Receipt 112191In KALLANGUR Date 26 Jul 2020 Card 462263xxxxxx7746,,-7,85.89,7
28/07/2020,WOOLWORTHS ONLINE 8843 - Visa Purchase - Receipt 112190In BELLA VISTA Date 26 Jul 2020 Card 462263xxxxxx7746,,-45.3,92.89,45.3
28/07/2020,BIG W 0246 - Visa Purchase - Receipt 112189In NORTHLAKES Date 26 Jul 2020 Card 462263xxxxxx7746,,-52.25,138.19,52.25
28/07/2020,ROCKS CAFE AND BOATHIR - Visa Purchase - Receipt 112188In GRIFFIN Date 26 Jul 2020 Card 462263xxxxxx7746,,-13.5,190.44,13.5
28/07/2020,SHAVER SHOP MANGO HILL - Visa Purchase - Receipt 112187In MANGO HILL Date 26 Jul 2020 Card 462263xxxxxx7746,,-44.9,203.94,44.9
27/07/2020,KALLANGUR GROCERS      KA LLANGUR QLD - EFTPOS Purchase - Receipt 4042Date 27 Jul 2020 Time 4:36PM Card 462263xxxxxx7746,,-56.93,248.84,56.93
27/07/2020,WU 2020686134898044 - Visa Purchase - Receipt 109721In 180-017-3833 Date 25 Jul 2020 Card 462263xxxxxx7746,,-402.9,305.77,402.9
27/07/2020,ALDI STORES - KALLANGU - Visa Purchase - Receipt 109720In KALLANGUR Date 24 Jul 2020 Card 462263xxxxxx7746,,-4.6,708.67,4.6
26/07/2020,Kogan MoneyBlackCard          4813635950084279 - BPAY Bill Payment - Receipt 508849 To Kogan MoneyBlackCard 4813635950084279,,-71.56,613.27,71.56
26/07/2020,International Transaction Fee - Receipt 144978,,-0.55,684.28,0.55
26/07/2020,PAYPAL *BAOZHOUXINX EB - Visa Purchase - Receipt 144978Foreign Currency Amount:  0In 4029357733 Date 24 Jul 2020 Card 462263xxxxxx7746,,-21.95,684.83,21.95
26/07/2020,COMPASS LCCH - Visa Purchase - Receipt 144977In SOUTH BRISBA Date 23 Jul 2020 Card 462263xxxxxx7495,,-3.83,706.78,3.83
26/07/2020,RADHE SPICE PTY LTD - Visa Purchase - Receipt 144976In NORTH LAKES Date 23 Jul 2020 Card 462263xxxxxx7746,,-30.73,710.61,30.73
26/07/2020,MICROSOFT*EA ACCESS 1 MON - Visa Purchase - Receipt 144975In MSBILL.INFO Date 23 Jul 2020 Card 462263xxxxxx7746,,-6.99,741.34,6.99
25/07/2020,TRANSLINK - Visa Purchase - Receipt 139171In BRISBANE Date 23 Jul 2020 Card 462263xxxxxx7746,,-20,748.33,20
24/07/2020,AZMAN HAROON - Visa Purchase - Receipt 169951In NORTH LAKES Date 22 Jul 2020 Card 462263xxxxxx7746,,-35.48,68.33,35.48
24/07/2020,AUSSIE SEAFOOD HOUSE - Visa Purchase - Receipt 169950In LAWNTON Date 23 Jul 2020 Card 462263xxxxxx7746,,-14.15,103.81,14.15
24/07/2020,TRANSLINK - Visa Purchase - Receipt 169949In BRISBANE Date 22 Jul 2020 Card 462263xxxxxx7746,,-20,117.96,20
24/07/2020,Audible Australia - Visa Purchase - Receipt 169948In MELBOURNE Date 22 Jul 2020 Card 462263xxxxxx7746,,-16.45,137.96,16.45
23/07/2020,Goodstart Murrum - Direct Debit - Receipt 164718 A005D2YA0VNP,,-231.16,154.41,231.16
23/07/2020,UNITYWATER - CABOOLTUR - Visa Purchase - Receipt 103627In CABOOLTURE Date 21 Jul 2020 Card 462263xxxxxx7746,,-395.61,185.57,395.61
23/07/2020,ALDI STORES - KALLANGU - Visa Purchase - Receipt 103626In KALLANGUR Date 20 Jul 2020 Card 462263xxxxxx7746,,-32.88,581.18,32.88
22/07/2020,Raiz Investment - Direct Debit - Receipt 128928 8cddbb2e1dce52f4b3,,-25.68,614.06,25.68
22/07/2020,OPTUS BILLING - Direct Debit - Receipt 167805 62173942475,,-99,639.74,99
22/07/2020,SQ *HI BROW N LASH LOU - Visa Purchase - Receipt 175992In Griffin Date 20 Jul 2020 Card 462263xxxxxx7495,,-15,738.74,15
22/07/2020,MORETON MEDICAL EQUIP - Visa Purchase - Receipt 175991In REDCLIFFE Date 20 Jul 2020 Card 462263xxxxxx7495,,-49.95,753.74,49.95
22/07/2020,RED DOG PETROLEUM - Visa Purchase - Receipt 175990In KALLANGUR Date 20 Jul 2020 Card 462263xxxxxx7746,,-51.74,803.69,51.74
22/07/2020,KALLANGUR DAY AND NIGH - Visa Purchase - Receipt 175989In KALLANGUR Date 20 Jul 2020 Card 462263xxxxxx7746,,-7.99,855.43,7.99
22/07/2020,NETFLIX COM - Visa Purchase - Receipt 175988In MELBOURNE Date 19 Jul 2020 Card 462263xxxxxx7746,,-13.99,863.42,13.99
21/07/2020,GRIFFIN C D PHARMACY - Visa Purchase - Receipt 101956In GRIFFIN Date 20 Jul 2020 Card 462263xxxxxx7746,,-12.99,877.41,12.99
21/07/2020,WOOLWORTHS ONLINE 8843 - Visa Purchase - Receipt 101955In BELLA VISTA Date 19 Jul 2020 Card 462263xxxxxx7746,,-39.76,890.4,39.76
21/07/2020,WOOLWORTHS 2752 - Visa Purchase - Receipt 101954In KALLANGUR Date 19 Jul 2020 Card 462263xxxxxx7746,,-20,930.16,20
21/07/2020,MSFT *<E0400BGMOT> - Visa Purchase - Receipt 101953In MSFT AZURE Date 18 Jul 2020 Card 462263xxxxxx7746,,-2.83,950.16,2.83
19/07/2020,BUNNINGS 376000 - Visa Purchase - Receipt 167986In NORTH LAKES Date 16 Jul 2020 Card 462263xxxxxx7746,,-145.42,552.99,145.42
19/07/2020,COMPASS LCCH - Visa Purchase - Receipt 167985In SOUTH BRISBA Date 16 Jul 2020 Card 462263xxxxxx7495,,-8.47,698.41,8.47
18/07/2020,TRANSLINK - Visa Purchase - Receipt 158738In BRISBANE Date 16 Jul 2020 Card 462263xxxxxx7746,,-20,706.88,20
18/07/2020,Microsoft*Microsoft 365 P - Visa Purchase - Receipt 158737In msbill.info Date 16 Jul 2020 Card 462263xxxxxx7746,,-10,726.88,10
17/07/2020,LEASE PAY - Direct Debit - Receipt 124466 001-1347737-001,,-861,736.88,861
17/07/2020,All Direct debits - Transfer to Kiran Joy - Receipt 82296 To 032885 5310008,,-3100,1597.88,3100
17/07/2020,COSTCO WHOLESALE AUS - Visa Purchase - Receipt 133800In NORTH LAKES Date 15 Jul 2020 Card 462263xxxxxx7746,,-74.35,4697.88,74.35
17/07/2020,BUNNINGS 376000 - Visa Purchase - Receipt 133799In NORTH LAKES Date 14 Jul 2020 Card 462263xxxxxx7746,,-69.04,4772.23,69.04
17/07/2020,COSTCO WHOLESALE AUSTR - Visa Purchase - Receipt 133798In NORTH LAKES Date 15 Jul 2020 Card 462263xxxxxx7746,,-18.98,4841.27,18.98
17/07/2020,COSTCO WHOLESALE AUSTR - Visa Purchase - Receipt 133797In NORTH LAKES Date 15 Jul 2020 Card 462263xxxxxx7746,,-1.49,4860.25,1.49
17/07/2020,COMPASS LCCH - Visa Purchase - Receipt 133796In SOUTH BRISBA Date 14 Jul 2020 Card 462263xxxxxx7495,,-3.83,4861.74,3.83
17/07/2020,TRANSLINK - Visa Purchase - Receipt 133795In BRISBANE Date 15 Jul 2020 Card 462263xxxxxx7746,,-20,4865.57,20
16/07/2020,Goodstart Murrum - Direct Debit - Receipt 160024 A005C5Q60RP5,,-231,4885.57,231
16/07/2020,Internal Transfer - Internal Transfer - Receipt 655986 Orange Everyday 0065083812,,-345,5116.57,345
16/07/2020,Internal Transfer - Internal Transfer - Receipt 685425 Savings Maximiser 0046211237,,-690,5461.57,690
16/07/2020,Internal Transfer - Internal Transfer - Receipt 684884 Savings Maximiser 0046211453,,-1180,6151.57,1180
16/07/2020,ALDI STORES - KALLANGU - Visa Purchase - Receipt 152613In KALLANGUR Date 13 Jul 2020 Card 462263xxxxxx7746,,-75.23,7331.57,75.23
15/07/2020,Raiz Investment - Direct Debit - Receipt 120771 fa38db6c194a064d92,,-20.6,7406.8,20.6
15/07/2020,Internal Transfer - Internal Transfer - Receipt 231494  0806227416,,-50,7427.4,50
15/07/2020,VODAFONE - Visa Purchase - Receipt 155336In NORTH SYDNEY Date 13 Jul 2020 Card 462263xxxxxx7746,,-69.59,7477.4,69.59
15/07/2020,DISNEY PLUS - Visa Purchase - Receipt 155335In RICHMOND Date 13 Jul 2020 Card 462263xxxxxx7746,,-8.99,7546.99,8.99
15/07/2020,TRANSLINK - Visa Purchase - Receipt 155334In BRISBANE Date 13 Jul 2020 Card 462263xxxxxx7746,,-20,7555.98,20
14/07/2020,CREMA NORTH LAKES - Visa Purchase - Receipt 117752In NORTH LAKES Date 13 Jul 2020 Card 462263xxxxxx7746,,-5.2,209.65,5.2
14/07/2020,ZWIFT  *Zyka The Real - Visa Purchase - Receipt 117751In 0734812181 Date 12 Jul 2020 Card 462263xxxxxx7746,,-41.59,214.85,41.59
14/07/2020,UHAUL AUST - Visa Purchase - Receipt 117750In WARANA Date 11 Jul 2020 Card 462263xxxxxx7746,,-56,256.44,56
14/07/2020,GLORIA J CABOOLTURE - Visa Purchase - Receipt 117749In CABOOLTURE Date 10 Jul 2020 Card 462263xxxxxx7495,,-8.9,312.44,8.9
14/07/2020,WOOLWORTHS 2752 - Visa Purchase - Receipt 117748In KALLANGUR Date 11 Jul 2020 Card 462263xxxxxx7746,,-29.59,321.34,29.59
14/07/2020,BUNNINGS 577000 - Visa Purchase - Receipt 117747In LAWNTON Date 11 Jul 2020 Card 462263xxxxxx7746,,-277.6,350.93,277.6
13/07/2020,BASKIN ROBBINS NLAKES - Visa Purchase - Receipt 158764In NORTH LAKES Date 10 Jul 2020 Card 462263xxxxxx7746,,-10.4,628.53,10.4
12/07/2020,KMART 1228 NORTH LAKES - EFTPOS Purchase - Receipt 161829Date 12 Jul 2020 Time 9:57AM Card 462263xxxxxx7746,,-35,638.93,35
12/07/2020,SUPER CHEAP AUTO - Visa Purchase - Receipt 198153In KALLANGUR Date 09 Jul 2020 Card 462263xxxxxx7746,,-20.99,673.93,20.99
12/07/2020,OXFAM AUSTRALIA Q - Visa Purchase - Receipt 198152In CARLTON Date 10 Jul 2020 Card 462263xxxxxx7746,,-50,694.92,50
12/07/2020,SHAPLAND SWIM KALLAN - Visa Purchase - Receipt 198151In KALLANGUR Date 10 Jul 2020 Card 462263xxxxxx7746,,-82,744.92,82
12/07/2020,BRIGHT SHADOW TRADIN - Visa Purchase - Receipt 198150In GRIFFIN Date 10 Jul 2020 Card 462263xxxxxx7746,,-5,826.92,5
11/07/2020,SUPER CHEAP AUTO - Visa Purchase - Receipt 193210In KALLANGUR Date 08 Jul 2020 Card 462263xxxxxx7746,,-35.48,331.92,35.48
11/07/2020,WOOLWORTHS 2752 - Visa Purchase - Receipt 193209In KALLANGUR Date 09 Jul 2020 Card 462263xxxxxx7746,,-5.72,367.4,5.72
11/07/2020,RUBY'S BAKERY AND CA - Visa Purchase - Receipt 193208In KALLANGUR Date 09 Jul 2020 Card 462263xxxxxx7746,,-11.6,373.12,11.6
10/07/2020,COSTCO FUEL NORTH LAKE NORTH LAKES - EFTPOS Purchase - Receipt 71023Date 10 Jul 2020 Time 8:38PM Card 462263xxxxxx7746,,-67.65,384.72,67.65
10/07/2020,COSTCO FUEL NORTH LAKE NORTH LAKES - EFTPOS Purchase - Receipt 71021Date 10 Jul 2020 Time 8:38PM Card 462263xxxxxx7746,,-80,372.37,80
10/07/2020,COLES 4404 CABOOLTURE - EFTPOS Purchase - Receipt 225468Date 10 Jul 2020 Time 4:18PM Card 462263xxxxxx7495,,-10,352.37,10
10/07/2020,ROCKS CAFE AND BOATHIR - Visa Purchase - Receipt 123172In GRIFFIN Date 08 Jul 2020 Card 462263xxxxxx7746,,-6,362.37,6
10/07/2020,TRANSLINK - Visa Purchase - Receipt 123171In BRISBANE Date 08 Jul 2020 Card 462263xxxxxx7746,,-20,368.37,20
9/07/2020,GOURMET MEATS - Visa Purchase - Receipt 169672In MURRUMBA DOW Date 08 Jul 2020 Card 462263xxxxxx7746,,-59.05,388.37,59.05
9/07/2020,ROCKS CAFE AND BOATHIR - Visa Purchase - Receipt 169671In GRIFFIN Date 08 Jul 2020 Card 462263xxxxxx7746,,-10.5,447.42,10.5
9/07/2020,WOOLWORTHS 2752 - Visa Purchase - Receipt 169670In KALLANGUR Date 07 Jul 2020 Card 462263xxxxxx7746,,-40.29,457.92,40.29
9/07/2020,TRANSLINK - Visa Purchase - Receipt 169669In BRISBANE Date 07 Jul 2020 Card 462263xxxxxx7746,,-20,498.21,20
9/07/2020,ALDI STORES - KALLANGU - Visa Purchase - Receipt 169668In KALLANGUR Date 06 Jul 2020 Card 462263xxxxxx7746,,-8.04,518.21,8.04
9/07/2020,MCDONALDS KALLANGUR - Visa Purchase - Receipt 169667In KALLANGUR Date 06 Jul 2020 Card 462263xxxxxx7746,,-4.2,526.25,4.2
8/07/2020,Raiz Investment - Direct Debit - Receipt 142455 39cde76681732ed74f,,-20.57,530.45,20.57
8/07/2020,Initial Deposit - Internal Transfer - Receipt 676486  0806227416,,-50,551.02,50
8/07/2020,MCDONALDS NORTH LAKES - Visa Purchase - Receipt 133859In NORTH LAKES Date 03 Jul 2020 Card 462263xxxxxx7746,,-10.6,601.02,10.6
7/07/2020,CHEMIST WAREHOUSE - Visa Purchase - Receipt 126833In MANGO HILL Date 04 Jul 2020 Card 462263xxxxxx7746,,-11.99,546.62,11.99
7/07/2020,WOOLWORTHS 2752 - Visa Purchase - Receipt 126832In KALLANGUR Date 05 Jul 2020 Card 462263xxxxxx7746,,-12.23,558.61,12.23
7/07/2020,WOOLWORTHS ONLINE 8843 - Visa Purchase - Receipt 126831In BELLA VISTA Date 05 Jul 2020 Card 462263xxxxxx7746,,-32.4,570.84,32.4
7/07/2020,KALLANGUR DAY AND NIGH - Visa Purchase - Receipt 126830In KALLANGUR Date 05 Jul 2020 Card 462263xxxxxx7746,,-23.95,603.24,23.95
6/07/2020,Hungry Jacks Kippa-Ring - EFTPOS Purchase - Receipt 349706Date 06 Jul 2020 Time 8:35PM Card 462263xxxxxx7746,,-29.3,627.19,29.3
6/07/2020,Guzman y Gomez North - Visa Purchase - Receipt 151340In North Lakes Date 05 Jul 2020 Card 462263xxxxxx7746,,-34.9,156.49,34.9
5/07/2020,KALLANGUR GROCERS      KA LLANGUR QLD - EFTPOS Purchase - Receipt 3047Date 05 Jul 2020 Time 4:41PM Card 462263xxxxxx7746,,-31.21,191.39,31.21
5/07/2020,International Transaction Fee - Receipt 136142,,-0.36,122.24,0.36
5/07/2020,ADOBE PHOTOGPHY PLAN - Visa Purchase - Receipt 136142Foreign Currency Amount:  0In ADOBE.LY/ENA Date 03 Jul 2020 Card 462263xxxxxx7746,,-14.29,122.6,14.29
5/07/2020,Ollie's Place - Visa Purchase - Receipt 136141In Mitchelton Date 04 Jul 2020 Card 462263xxxxxx7746,,-39.18,136.89,39.18
5/07/2020,BWS 2482 - Visa Purchase - Receipt 136140In GRIFFIN Date 03 Jul 2020 Card 462263xxxxxx7746,,-5,176.07,5
5/07/2020,ALDI STORES - KALLANGU - Visa Purchase - Receipt 136139In KALLANGUR Date 02 Jul 2020 Card 462263xxxxxx7746,,-18.53,181.07,18.53
5/07/2020,BRIGHT SHADOW TRADIN - Visa Purchase - Receipt 136138In GRIFFIN Date 03 Jul 2020 Card 462263xxxxxx7746,,-6,199.6,6
5/07/2020,COMPASS LCCH - Visa Purchase - Receipt 136137In SOUTH BRISBA Date 02 Jul 2020 Card 462263xxxxxx7495,,-6.55,205.6,6.55
4/07/2020,CASHCARD\7-ELEVEN GRIFFIN 4266\GRIFFI - Receipt 314ATM owner fee of $2.50 charged by CASHCARD\7-ELEVEN GRIFFIN 4266\GRIFFIDate 04 Jul 2020 Time 6:59PM Card 462263xxxxxx7746,,-402.5,209.65,402.5
4/07/2020,ALDI STORES - BURPENGA BURPENGARY - EFTPOS Purchase - Receipt 73924Date 04 Jul 2020 Time 6:40PM Card 462263xxxxxx7746,,-11.86,612.15,11.86
4/07/2020,COLES 4430 MITCHELTON - EFTPOS Purchase - Receipt 328989Date 04 Jul 2020 Time 12:31PM Card 462263xxxxxx7746,,-8.45,224.01,8.45
4/07/2020,BASKIN ROBBINS NLAKES - Visa Purchase - Receipt 193717In NORTH LAKES Date 01 Jul 2020 Card 462263xxxxxx7746,,-5.2,132.46,5.2
4/07/2020,Cotton On - Visa Purchase - Receipt 193716In Geelong Date 02 Jul 2020 Card 462263xxxxxx7746,,-43.5,137.66,43.5
4/07/2020,KINN NORTH LAKES PTY - Visa Purchase - Receipt 193715In NORTH LAKES Date 01 Jul 2020 Card 462263xxxxxx7746,,-74,181.16,74
4/07/2020,SOUTH BANK STATION - Visa Purchase - Receipt 193714In SOUTH BRISBA Date 01 Jul 2020 Card 462263xxxxxx7495,,-9.1,255.16,9.1
3/07/2020,WOOLWORTHS ONLINE 8843 - Visa Purchase - Receipt 190386In BELLA VISTA Date 01 Jul 2020 Card 462263xxxxxx7746,,-53.33,259.59,53.33
3/07/2020,TRANSLINK - Visa Purchase - Receipt 190385In BRISBANE Date 01 Jul 2020 Card 462263xxxxxx7746,,-20,312.92,20
2/07/2020,ALDI STORES - NORTH LA - Visa Purchase - Receipt 184287In NORTH LAKES Date 29 Jun 2020 Card 462263xxxxxx7746,,-17.89,232.92,17.89
2/07/2020,ALDI STORES - NORTH LA - Visa Purchase - Receipt 184286In NORTH LAKES Date 29 Jun 2020 Card 462263xxxxxx7746,,-9.3,250.81,9.3
2/07/2020,GRIFFIN MEDICAL CENT - Visa Purchase - Receipt 184285In GRIFFIN Date 30 Jun 2020 Card 462263xxxxxx7495,,-110,260.11,110
1/07/2020,Kogan MoneyBlackCard          4813635950084279 - BPAY Bill Payment - Receipt 833327 To Kogan MoneyBlackCard 4813635950084279,,-32.3,370.11,32.3
1/07/2020,Raiz Maint Fee - Direct Debit - Receipt 113873 670ab32672e5f00b96,,-2.5,402.41,2.5
1/07/2020,WU 2018182482217775 - Visa Purchase - Receipt 139347In 180-017-3833 Date 29 Jun 2020 Card 462263xxxxxx7746,,-302.9,304.91,302.9
1/07/2020,TRANSLINK - Visa Purchase - Receipt 139346In BRISBANE Date 29 Jun 2020 Card 462263xxxxxx7746,,-20,607.81,20
1/07/2020,OP STORECO PTY LTD - Visa Purchase - Receipt 139345In MANGO HILL Date 26 Jun 2020 Card 462263xxxxxx7746,,-38.45,627.81,38.45
30/06/2020,KMART 1228 NORTH LAKES - EFTPOS Purchase - Receipt 201259Date 30 Jun 2020 Time 2:41PM Card 462263xxxxxx7746,,-77.5,580.11,77.5
30/06/2020,SUBWAY MURRUMBA DOWNS - Visa Purchase - Receipt 112500In MURRUMBA DOW Date 28 Jun 2020 Card 462263xxxxxx7746,,-16.25,517.61,16.25
30/06/2020,WOOLWORTHS ONLINE 8843 - Visa Purchase - Receipt 112499In BELLA VISTA Date 27 Jun 2020 Card 462263xxxxxx7746,,-44.6,533.86,44.6
30/06/2020,COSTCO FUEL NORTH LAKE NORTH LAKES - EFTPOS Purchase - Receipt 41442Date 30 Jun 2020 Time 9:24AM Card 462263xxxxxx7746,,-62.27,578.46,62.27
30/06/2020,COSTCO FUEL NORTH LAKE NORTH LAKES - EFTPOS Purchase - Receipt 41440Date 30 Jun 2020 Time 9:24AM Card 462263xxxxxx7746,,-70,570.73,70
29/06/2020,AMZNPRIMEAU MEMBERSHIP - Visa Purchase - Receipt 112537In SYDNEY SOUTH Date 28 Jun 2020 Card 462263xxxxxx7746,,-6.99,640.73,6.99
29/06/2020,ROCKS CAFE AND BOATHIR - Visa Purchase - Receipt 112536In GRIFFIN Date 28 Jun 2020 Card 462263xxxxxx7746,,-2.5,647.72,2.5
29/06/2020,ROCKS CAFE AND BOATHIR - Visa Purchase - Receipt 112535In GRIFFIN Date 28 Jun 2020 Card 462263xxxxxx7746,,-4.5,650.22,4.5
29/06/2020,ALDI STORES - KALLANGU - Visa Purchase - Receipt 112534In KALLANGUR Date 26 Jun 2020 Card 462263xxxxxx7746,,-3.6,654.72,3.6
29/06/2020,HOME AFFAIRS - ONLINE - Visa Purchase - Receipt 112533In SOUTHPORT Date 27 Jun 2020 Card 462263xxxxxx7746,,-288.76,658.32,288.76
28/06/2020,ROCKS CAFE AND BOATHIR - Visa Purchase - Receipt 129361In GRIFFIN Date 26 Jun 2020 Card 462263xxxxxx7746,,-16,568.03,16
28/06/2020,BWS 2482 - Visa Purchase - Receipt 129360In GRIFFIN Date 26 Jun 2020 Card 462263xxxxxx7746,,-8,584.03,8
28/06/2020,POST KALLANGUR LPO  KA - Visa Purchase - Receipt 129359In KALLANGUR Date 26 Jun 2020 Card 462263xxxxxx7746,,-1.35,592.03,1.35
27/06/2020,GRIFFIN C D PHARMACY - Visa Purchase - Receipt 131380In GRIFFIN Date 26 Jun 2020 Card 462263xxxxxx7746,,-10.95,93.38,10.95
27/06/2020,ALDI STORES - NORTH LA - Visa Purchase - Receipt 131379In NORTH LAKES Date 24 Jun 2020 Card 462263xxxxxx7746,,-11.75,104.33,11.75
26/06/2020,GRIFFIN C D PHARMACY - Visa Purchase - Receipt 154765In GRIFFIN Date 25 Jun 2020 Card 462263xxxxxx7746,,-57.9,116.08,57.9
26/06/2020,ROCKS CAFE AND BOATHIR - Visa Purchase - Receipt 154764In GRIFFIN Date 25 Jun 2020 Card 462263xxxxxx7746,,-14,173.98,14
26/06/2020,MICROSOFT*EA ACCESS 1 MON - Visa Purchase - Receipt 154763In MSBILL.INFO Date 24 Jun 2020 Card 462263xxxxxx7746,,-6.99,187.98,6.99
26/06/2020,GOURMET MEATS - Visa Purchase - Receipt 154762In MURRUMBA DOW Date 24 Jun 2020 Card 462263xxxxxx7746,,-50.6,194.97,50.6
26/06/2020,KITCHEN WAREHOUSE PT - Visa Purchase - Receipt 154761In NORTH LAKES Date 24 Jun 2020 Card 462263xxxxxx7746,,-4.95,245.57,4.95
25/06/2020,TRANSLINK - Visa Purchase - Receipt 133395In BRISBANE Date 23 Jun 2020 Card 462263xxxxxx7746,,-20,150.52,20
25/06/2020,ALDI STORES - KALLANGU - Visa Purchase - Receipt 133394In KALLANGUR Date 22 Jun 2020 Card 462263xxxxxx7746,,-22.66,170.52,22.66
25/06/2020,COLES 4561 - Visa Purchase - Receipt 133393In MURRUMBA DWN Date 24 Jun 2020 Card 462263xxxxxx7746,,-11.47,193.18,11.47
24/06/2020,BABYHEART - Visa Purchase - Receipt 100920In WELSHPOOL Date 23 Jun 2020 Card 462263xxxxxx7746,,-23.99,204.65,23.99
24/06/2020,Audible Australia - Visa Purchase - Receipt 100919In MELBOURNE Date 22 Jun 2020 Card 462263xxxxxx7746,,-16.45,228.64,16.45
24/06/2020,ALDI STORES - KALLANGU - Visa Purchase - Receipt 100918In KALLANGUR Date 21 Jun 2020 Card 462263xxxxxx7746,,-28.92,245.09,28.92
24/06/2020,FRUITY DISCOUNTS PTY - Visa Purchase - Receipt 100917In DECEPTION BA Date 21 Jun 2020 Card 462263xxxxxx7746,,-45.94,274.01,45.94
23/06/2020,THAI WHARF RESTAURAN - Visa Purchase - Receipt 104780In MORAYFIELD Date 21 Jun 2020 Card 462263xxxxxx7746,,-43.5,319.95,43.5
22/06/2020,LEASE PAY - Direct Debit - Receipt 111333 001-1347737-001,,-861,363.45,861
22/06/2020,OPTUS BILLING - Direct Debit - Receipt 103536 62173942475,,-88.84,1067.45,88.84
22/06/2020,MSFT *<E0400B7248> - Visa Purchase - Receipt 189200In MSFT AZURE Date 19 Jun 2020 Card 462263xxxxxx7746,,-2.82,1156.29,2.82
22/06/2020,SUBWAY MANGO HILL - Visa Purchase - Receipt 189199In NORTH LAKES Date 20 Jun 2020 Card 462263xxxxxx7746,,-16.9,1159.11,16.9
21/06/2020,TRANSLINK - Visa Purchase - Receipt 197074In BRISBANE Date 19 Jun 2020 Card 462263xxxxxx7746,,-20,1156.02,20
21/06/2020,DAN MURPHYS 2102 MANGO - Visa Purchase - Receipt 197073In NORTH LAKES Date 19 Jun 2020 Card 462263xxxxxx7746,,-53.99,1176.02,53.99
20/06/2020,ANACONDA NORTH LAKE    NO RTH LAKES - EFTPOS Purchase - Receipt 7979Date 20 Jun 2020 Time 11:14AM Card 462263xxxxxx7746,,-10.99,1230.01,10.99
20/06/2020,NETFLIX.COM - Visa Purchase - Receipt 178659In Melbourne Date 18 Jun 2020 Card 462263xxxxxx7746,,-13.99,1241,13.99
20/06/2020,WOOLWORTHS 2752 - Visa Purchase - Receipt 178658In KALLANGUR Date 18 Jun 2020 Card 462263xxxxxx7746,,-6.5,1254.99,6.5
20/06/2020,TRANSLINK - Visa Purchase - Receipt 178657In BRISBANE Date 18 Jun 2020 Card 462263xxxxxx7746,,-20,1261.49,20
20/06/2020,ALIEXPRESS.COM - Visa Purchase - Receipt 178656In Melbourne Date 18 Jun 2020 Card 462263xxxxxx7746,,-64.68,1281.49,64.68
19/06/2020,COSTCO FUEL NORTH LAKE NORTH LAKES - EFTPOS Purchase - Receipt 41420Date 19 Jun 2020 Time 3:29PM Card 462263xxxxxx7746,,-63.56,1346.17,63.56
19/06/2020,COSTCO FUEL NORTH LAKE NORTH LAKES - EFTPOS Purchase - Receipt 41418Date 19 Jun 2020 Time 3:29PM Card 462263xxxxxx7746,,-80,1329.73,80
18/06/2020,MICROSOFT*MICROSOFT 365 P - Visa Purchase - Receipt 158122In MSBILL.INFO Date 16 Jun 2020 Card 462263xxxxxx7746,,-10,409.73,10
17/06/2020,Direct Debit,,-861,-441.27,861
17/06/2020,Raiz Maint Fee - Direct Debit - Receipt 105989 5e9118d08f4b75e19c,,-2.5,419.73,2.5
17/06/2020,All Direct debits - Transfer to Kiran Joy - Receipt 886534 To 032885 5310008,,-3100,222.23,3100
17/06/2020,KMART 1228 - Visa Purchase - Receipt 188977In NORTH LAKES Date 16 Jun 2020 Card 462263xxxxxx7746,,-39,3322.23,39
17/06/2020,MCDONALDS MURRUMBA DO - Visa Purchase - Receipt 188976In MURRUMBA DOW Date 13 Jun 2020 Card 462263xxxxxx7746,,-29.15,3361.23,29.15
17/06/2020,WOOLWORTHS 2752 - Visa Purchase - Receipt 188975In KALLANGUR Date 15 Jun 2020 Card 462263xxxxxx7746,,-20.04,3390.38,20.04
17/06/2020,TRANSLINK - Visa Purchase - Receipt 188974In BRISBANE Date 15 Jun 2020 Card 462263xxxxxx7746,,-20,3410.42,20
17/06/2020,TRRYWHT CHM MURRUMB - Visa Purchase - Receipt 188973In MURRUMBA DOW Date 13 Jun 2020 Card 462263xxxxxx7746,,-8.95,3430.42,8.95
16/06/2020,WOOLWORTHS ONLINE 8843 - Visa Purchase - Receipt 126551In BELLA VISTA Date 15 Jun 2020 Card 462263xxxxxx7746,,-45.99,2439.37,45.99
16/06/2020,BABY BUNTING PL - Visa Purchase - Receipt 126550In NORTH LAKES Date 13 Jun 2020 Card 462263xxxxxx7746,,-54.75,2485.36,54.75
16/06/2020,Internal Transfer - Internal Transfer - Receipt 413239 Savings Maximiser 0046211453,,-1180,2540.11,1180
16/06/2020,Internal Transfer - Internal Transfer - Receipt 412891 Savings Maximiser 0046211237,,-690,3720.11,690
16/06/2020,Internal Transfer - Internal Transfer - Receipt 176866 Orange Everyday 0065083812,,-345,4410.11,345
15/06/2020,DISNEY PLUS - Visa Purchase - Receipt 130616In RICHMOND Date 13 Jun 2020 Card 462263xxxxxx7746,,-8.99,4755.11,8.99
14/06/2020,Kogan MoneyBlackCard          4813635950084279 - BPAY Bill Payment - Receipt 26257 To Kogan MoneyBlackCard 4813635950084279,,-2724.98,4764.1,2724.98
14/06/2020,KALLANGUR GROCERS      KA LLANGUR QLD - EFTPOS Purchase - Receipt 2000Date 14 Jun 2020 Time 2:44PM Card 462263xxxxxx7746,,-19.76,7489.08,19.76
14/06/2020,COLES 4561 - Visa Purchase - Receipt 160425In MURRUMBA DWN Date 13 Jun 2020 Card 462263xxxxxx7746,,-92.52,7508.84,92.52
14/06/2020,GRIFFIN PIZZA - Visa Purchase - Receipt 160424In GRIFFIN Date 12 Jun 2020 Card 462263xxxxxx7746,,-16,7601.36,16
14/06/2020,BWS 2482 - Visa Purchase - Receipt 160423In GRIFFIN Date 12 Jun 2020 Card 462263xxxxxx7746,,-39,7617.36,39
14/06/2020,SOMERVILLE HOUSE - Visa Purchase - Receipt 160422In SOUTH BRISBA Date 12 Jun 2020 Card 462263xxxxxx7495,,-4.05,7656.36,4.05
14/06/2020,BRIGHT SHADOW TRADIN - Visa Purchase - Receipt 160421In GRIFFIN Date 12 Jun 2020 Card 462263xxxxxx7746,,-6,7660.41,6
13/06/2020,SPOTLIGHT NORTH LAK    NO RTH LAKES - EFTPOS Purchase - Receipt 11686Date 13 Jun 2020 Time 10:42AM Card 462263xxxxxx7746,,-15.2,7666.41,15.2
13/06/2020,VODAFONE - Visa Purchase - Receipt 169593In NORTH SYDNEY Date 11 Jun 2020 Card 462263xxxxxx7746,,-69.59,7681.61,69.59
13/06/2020,TRANSLINK - Visa Purchase - Receipt 169592In BRISBANE Date 11 Jun 2020 Card 462263xxxxxx7746,,-20,7751.2,20
13/06/2020,SHAPLAND SWIM KALLAN - Visa Purchase - Receipt 169591In KALLANGUR Date 11 Jun 2020 Card 462263xxxxxx7746,,-82,7771.2,82
12/06/2020,LIVING FAITH LUTHERA - Visa Purchase - Receipt 143213In MURRUMBA DOW Date 10 Jun 2020 Card 462263xxxxxx7746,,-25,231.87,25
12/06/2020,OXFAM AUSTRALIA Q - Visa Purchase - Receipt 143212In CARLTON Date 10 Jun 2020 Card 462263xxxxxx7746,,-50,256.87,50
11/06/2020,TRANSLINK - Visa Purchase - Receipt 119595In BRISBANE Date 09 Jun 2020 Card 462263xxxxxx7746,,-20,206.87,20
11/06/2020,ALDI STORES - KALLANGU - Visa Purchase - Receipt 119594In KALLANGUR Date 08 Jun 2020 Card 462263xxxxxx7746,,-44.38,226.87,44.38
10/06/2020,MCDONALDS KALLANGUR - Visa Purchase - Receipt 174188In KALLANGUR Date 05 Jun 2020 Card 462263xxxxxx7746,,-3,171.25,3
10/06/2020,TRANSLINK - Visa Purchase - Receipt 174187In BRISBANE Date 08 Jun 2020 Card 462263xxxxxx7746,,-20,174.25,20
10/06/2020,POST KALLANGUR LPO  KA - Visa Purchase - Receipt 174186In KALLANGUR Date 06 Jun 2020 Card 462263xxxxxx7746,,-27.93,194.25,27.93
10/06/2020,LIV*BIG LICK ICECREAM - Visa Purchase - Receipt 174185In REDCLIFFE Date 07 Jun 2020 Card 462263xxxxxx7746,,-11.17,222.18,11.17
9/06/2020,D & K SMOKING PTY LT - Visa Purchase - Receipt 189427In ELIMBAH Date 07 Jun 2020 Card 462263xxxxxx7746,,-14.9,233.35,14.9
9/06/2020,AZMAN HAROON - Visa Purchase - Receipt 189426In NORTH LAKES Date 07 Jun 2020 Card 462263xxxxxx7746,,-56.47,248.25,56.47
9/06/2020,ASOS AU SALES LLC - Visa Purchase - Receipt 189425In ASOS.COM Date 07 Jun 2020 Card 462263xxxxxx7746,,-114.24,304.72,114.24
9/06/2020,WOOLWORTHS ONLINE 8843 - Visa Purchase - Receipt 189424In BELLA VISTA Date 07 Jun 2020 Card 462263xxxxxx7746,,-56.05,418.96,56.05
9/06/2020,KALLANGUR GROCERS - Visa Purchase - Receipt 189423In KALLANGUR Date 07 Jun 2020 Card 462263xxxxxx7746,,-10.52,475.01,10.52
9/06/2020,WOOLWORTHS 2752 - Visa Purchase - Receipt 189422In KALLANGUR Date 06 Jun 2020 Card 462263xxxxxx7746,,-11,485.53,11
9/06/2020,ALIEXPRESS.COM - Visa Purchase - Receipt 189421In Melbourne Date 07 Jun 2020 Card 462263xxxxxx7746,,-8.03,496.53,8.03
9/06/2020,LINKT BRISBANE - Visa Purchase - Receipt 189420In BRISBANE Date 06 Jun 2020 Card 462263xxxxxx7746,,-25.08,504.56,25.08
8/06/2020,Kokiyo - Visa Purchase - Receipt 183303In Mango Hill Date 07 Jun 2020 Card 462263xxxxxx7746,,-13.95,429.64,13.95
8/06/2020,ALDI STORES - KALLANGU - Visa Purchase - Receipt 183302In KALLANGUR Date 05 Jun 2020 Card 462263xxxxxx7746,,-20.33,443.59,20.33
8/06/2020,COSTCO FUEL NORTH LAKE - Visa Purchase - Receipt 183301In NORTH LAKES Date 06 Jun 2020 Card 462263xxxxxx7746,,-60,463.92,60
7/06/2020,BUNNINGS 376000 - Visa Purchase - Receipt 118405In NORTH LAKES Date 04 Jun 2020 Card 462263xxxxxx7746,,-52.5,223.92,52.5
7/06/2020,BUNNINGS 376000 - Visa Purchase - Receipt 118404In NORTH LAKES Date 04 Jun 2020 Card 462263xxxxxx7746,,-61.1,276.42,61.1
7/06/2020,BWS 2482 - Visa Purchase - Receipt 118403In GRIFFIN Date 05 Jun 2020 Card 462263xxxxxx7746,,-30,337.52,30
7/06/2020,SOMERVILLE HOUSE - Visa Purchase - Receipt 118402In SOUTH BRISBA Date 05 Jun 2020 Card 462263xxxxxx7495,,-9.9,367.52,9.9
6/06/2020,TRANSLINK - Visa Purchase - Receipt 153461In BRISBANE Date 04 Jun 2020 Card 462263xxxxxx7746,,-20,277.42,20
6/06/2020,ALDI STORES - KALLANGU - Visa Purchase - Receipt 153460In KALLANGUR Date 03 Jun 2020 Card 462263xxxxxx7746,,-28.69,297.42,28.69
5/06/2020,International Transaction Fee - Receipt 138465,,-0.36,260.75,0.36
5/06/2020,ADOBE PHOTOGPHY PLAN - Visa Purchase - Receipt 138465Foreign Currency Amount:  0In ADOBE.LY/ENA Date 03 Jun 2020 Card 462263xxxxxx7746,,-14.29,261.11,14.29
5/06/2020,RADHE SPICE PTY LTD - Visa Purchase - Receipt 138464In NORTH LAKES Date 02 Jun 2020 Card 462263xxxxxx7746,,-55.21,275.4,55.21
5/06/2020,TRANSLINK - Visa Purchase - Receipt 138463In BRISBANE Date 03 Jun 2020 Card 462263xxxxxx7746,,-20,330.61,20
4/06/2020,SQ *HI BROW N LASH LOU - Visa Purchase - Receipt 187966In Griffin Date 02 Jun 2020 Card 462263xxxxxx7495,,-15,250.61,15
4/06/2020,GOODSTART              MU RRUMBA DOWN - EFTPOS Purchase - Receipt 3846Date 04 Jun 2020 Time 9:16AM Card 462263xxxxxx7746,,-134.55,265.61,134.55
4/06/2020,Internal Transfer - Internal Transfer - Receipt 812094 Savings Maximiser 0046211237,,-100,200.16,100
3/06/2020,BUNNINGS 376000 - Visa Purchase - Receipt 115324In NORTH LAKES Date 31 May 2020 Card 462263xxxxxx7746,,-10.85,300.16,10.85
3/06/2020,MR TOYS - Visa Purchase - Receipt 115323In LAWNTON Date 30 May 2020 Card 462263xxxxxx7746,,-25.58,311.01,25.58
2/06/2020,Direct Debit,,-134.55,2.04,134.55
2/06/2020,GOURMET MEATS - Visa Purchase - Receipt 183741In MURRUMBA DOW Date 31 May 2020 Card 462263xxxxxx7746,,-25.8,136.59,25.8
2/06/2020,7-ELEVEN 4220 - Visa Purchase - Receipt 183740In NORTH LAKES Date 29 May 2020 Card 462263xxxxxx7746,,-5,162.39,5
2/06/2020,ALDI STORES - KALLANGU - Visa Purchase - Receipt 183739In KALLANGUR Date 30 May 2020 Card 462263xxxxxx7746,,-64.05,167.39,64.05
1/06/2020,Direct Debit,,-2.5,128.94,2.5
31/05/2020,COLES 4561 MURRUMBA DW - EFTPOS Purchase - Receipt 84980Date 31 May 2020 Time 12:34PM Card 462263xxxxxx7746,,-20.1,131.44,20.1
31/05/2020,IKEA NORTHLAKES NORTH LAKES - EFTPOS Purchase - Receipt 268138Date 31 May 2020 Time 12:07PM Card 462263xxxxxx7746,,-3.5,151.54,3.5
31/05/2020,IKEA NORTHLAKES NORTH LAKES - EFTPOS Purchase - Receipt 125869Date 31 May 2020 Time 12:01PM Card 462263xxxxxx7746,,-11.95,155.04,11.95
31/05/2020,IKEA NORTHLAKES NORTH LAKES - EFTPOS Purchase - Receipt 187612Date 31 May 2020 Time 11:57AM Card 462263xxxxxx7746,,-50.95,166.99,50.95
31/05/2020,SOMERVILLE HOUSE - Visa Purchase - Receipt 134478In SOUTH BRISBA Date 29 May 2020 Card 462263xxxxxx7495,,-4.05,217.94,4.05
31/05/2020,BRIGHT SHADOW TRADIN - Visa Purchase - Receipt 134477In GRIFFIN Date 29 May 2020 Card 462263xxxxxx7746,,-6,221.99,6
31/05/2020,SUBWAY NORTH LAKES BUS PK - Visa Purchase - Receipt 134476In NORTH LAKES Date 29 May 2020 Card 462263xxxxxx7746,,-12.2,227.99,12.2
31/05/2020,TRANSLINK - Visa Purchase - Receipt 134475In BRISBANE Date 29 May 2020 Card 462263xxxxxx7746,,-20,240.19,20
31/05/2020,BUNNINGS 376000 - Visa Purchase - Receipt 134474In NORTH LAKES Date 28 May 2020 Card 462263xxxxxx7746,,-9.48,260.19,9.48
30/05/2020,EZI*Core Electronics P - Visa Purchase - Receipt 101562In Ashtonfield Date 28 May 2020 Card 462263xxxxxx7746,,-156.4,269.67,156.4
30/05/2020,MBRC ONLINE PAYMENTS - Visa Purchase - Receipt 101561In STRATHPINE Date 29 May 2020 Card 462263xxxxxx7746,,-395.59,426.07,395.59
30/05/2020,ALDI STORES - KALLANGU - Visa Purchase - Receipt 101560In KALLANGUR Date 27 May 2020 Card 462263xxxxxx7746,,-43.19,821.66,43.19
30/05/2020,MCDONALDS KALLANGUR - Visa Purchase - Receipt 101559In KALLANGUR Date 27 May 2020 Card 462263xxxxxx7746,,-4.65,864.85,4.65
29/05/2020,AMZNPRIMEAU MEMBERSHIP - Visa Purchase - Receipt 131335In SYDNEY SOUTH Date 28 May 2020 Card 462263xxxxxx7746,,-6.99,769.5,6.99
29/05/2020,TRANSLINK - Visa Purchase - Receipt 131334In BRISBANE Date 27 May 2020 Card 462263xxxxxx7746,,-20,776.49,20
29/05/2020,COSTCO WHOLESALE AUS - Visa Purchase - Receipt 131333In NORTH LAKES Date 27 May 2020 Card 462263xxxxxx7746,,-25.37,796.49,25.37
28/05/2020,International Transaction Fee - Receipt 129416,,-2.02,176.84,2.02
28/05/2020,LASTPASS.COM - Visa Purchase - Receipt 129416Foreign Currency Amount: USD 52.8In 7818975012 Date 26 May 2020 Card 462263xxxxxx7746,,-80.8,178.86,80.8
28/05/2020,SOMERVILLE HOUSE - Visa Purchase - Receipt 129415In SOUTH BRISBA Date 26 May 2020 Card 462263xxxxxx7495,,-3.51,259.66,3.51
28/05/2020,TRANSLINK - Visa Purchase - Receipt 129414In BRISBANE Date 26 May 2020 Card 462263xxxxxx7746,,-20,263.17,20
28/05/2020,UBER *TRIP HELP.UBER.COM - Visa Purchase - Receipt 129413In Sydney Date 26 May 2020 Card 462263xxxxxx7746,,-13.85,283.17,13.85
27/05/2020,BUNNINGS 376000 - Visa Purchase - Receipt 145358In NORTH LAKES Date 24 May 2020 Card 462263xxxxxx7746,,-36.84,297.02,36.84
26/05/2020,COLES 4436 - Visa Purchase - Receipt 108744In MANGO HILL Date 25 May 2020 Card 462263xxxxxx7746,,-53.73,333.86,53.73
26/05/2020,MICROSOFT*EA ACCESS 1 MON - Visa Purchase - Receipt 108743In MSBILL.INFO Date 24 May 2020 Card 462263xxxxxx7746,,-6.99,387.59,6.99
26/05/2020,COSTCO FUEL NORTH LAKE - Visa Purchase - Receipt 108742In NORTH LAKES Date 24 May 2020 Card 462263xxxxxx7746,,-52.51,394.58,52.51
25/05/2020,Kogan MoneyBlackCard          4813635950084279 - BPAY Bill Payment - Receipt 63215 To Kogan MoneyBlackCard 4813635950084279,,-2200,447.09,2200
24/05/2020,KALLANGUR GROCERS      KA LLANGUR QLD - EFTPOS Purchase - Receipt 1129Date 24 May 2020 Time 4:53PM Card 462263xxxxxx7746,,-20.11,347.09,20.11
24/05/2020,WOOLWORTHS 2752 - Visa Purchase - Receipt 172101In KALLANGUR Date 22 May 2020 Card 462263xxxxxx7746,,-45.91,367.2,45.91
24/05/2020,Audible Australia - Visa Purchase - Receipt 172100In MELBOURNE Date 22 May 2020 Card 462263xxxxxx7746,,-16.45,413.11,16.45
22/05/2020,Direct Debit,,-21.9,-26.89,21.9
22/05/2020,Direct Debit,,-134.55,-4.99,134.55
22/05/2020,OPTUS BILLING - Direct Debit - Receipt 101942 62173942475,,-134,129.56,134
22/05/2020,TRANSLINK - Visa Purchase - Receipt 134541In BRISBANE Date 20 May 2020 Card 462263xxxxxx7746,,-20,263.56,20
21/05/2020,MSFT *<E0400AXORC> - Visa Purchase - Receipt 172619In MSFT AZURE Date 18 May 2020 Card 462263xxxxxx7746,,-2.82,283.56,2.82
21/05/2020,WOOLWORTHS ONLINE 8843 - Visa Purchase - Receipt 172618In BELLA VISTA Date 18 May 2020 Card 462263xxxxxx7746,,-45.9,286.38,45.9
21/05/2020,TRANSLINK - Visa Purchase - Receipt 172617In BRISBANE Date 19 May 2020 Card 462263xxxxxx7746,,-20,332.28,20
21/05/2020,NETFLIX COM - Visa Purchase - Receipt 172616In MELBOURNE Date 19 May 2020 Card 462263xxxxxx7746,,-13.99,352.28,13.99
21/05/2020,BUNNINGS 376000 - Visa Purchase - Receipt 172615In NORTH LAKES Date 18 May 2020 Card 462263xxxxxx7746,,-13.59,366.27,13.59
21/05/2020,ALDI STORES - NORTH LA - Visa Purchase - Receipt 172614In NORTH LAKES Date 18 May 2020 Card 462263xxxxxx7746,,-20.85,379.86,20.85
20/05/2020,RYDON GROUP HLDG P L - Visa Purchase - Receipt 164251In VARSITY LAKE Date 18 May 2020 Card 462263xxxxxx7746,,-260,400.71,260
20/05/2020,ALDI STORES - KALLANGU - Visa Purchase - Receipt 164250In KALLANGUR Date 17 May 2020 Card 462263xxxxxx7746,,-24.16,660.71,24.16
20/05/2020,MCDONALDS WINDSOR WES - Visa Purchase - Receipt 164249In WINDSOR Date 16 May 2020 Card 462263xxxxxx7746,,-28.15,684.87,28.15
19/05/2020,AMAZON MKTPLC AU - Visa Purchase - Receipt 169701In SYDNEY SOUTH Date 12 May 2020 Card 462263xxxxxx7746,,-19.25,513.02,19.25
19/05/2020,CREMA NORTH LAKES - Visa Purchase - Receipt 169700In NORTH LAKES Date 16 May 2020 Card 462263xxxxxx7746,,-8.1,532.27,8.1
18/05/2020,LEASE PAY - Direct Debit - Receipt 135508 001-1347737-001,,-861,540.37,861
18/05/2020,Raiz Investment - Direct Debit - Receipt 135507 897d636cf9ada22edd,,-21.7,1401.37,21.7
18/05/2020,MICROSOFT*MICROSOFT 365 P - Visa Purchase - Receipt 127717In MSBILL.INFO Date 16 May 2020 Card 462263xxxxxx7746,,-10,1423.07,10
18/05/2020,TRANSLINK - Visa Purchase - Receipt 148903In BRISBANE Date 15 May 2020 Card 462263xxxxxx7746,,-20,1433.07,20
18/05/2020,SURPRISEBRO  PTY LTD - Visa Purchase - Receipt 148902In NORTH LAKES Date 14 May 2020 Card 462263xxxxxx7746,,-11.9,1453.07,11.9
18/05/2020,BWS 2482 - Visa Purchase - Receipt 148901In GRIFFIN Date 15 May 2020 Card 462263xxxxxx7746,,-52,1464.97,52
18/05/2020,SOMERVILLE HOUSE - Visa Purchase - Receipt 148900In SOUTH BRISBA Date 15 May 2020 Card 462263xxxxxx7495,,-4.05,1516.97,4.05
17/05/2020,KALLANGUR GROCERS      KA LLANGUR QLD - EFTPOS Purchase - Receipt 817Date 17 May 2020 Time 11:07AM Card 462263xxxxxx7746,,-29.67,1521.02,29.67
17/05/2020,All Direct debits - Transfer to Kiran Joy - Receipt 695263 To 032885 5310008,,-2946,1550.69,2946
16/05/2020,KMART 1228 NORTH LAKES - EFTPOS Purchase - Receipt 194247Date 16 May 2020 Time 4:57PM Card 462263xxxxxx7746,,-46.15,4496.69,46.15
16/05/2020,TRANSPORTMAINRDS - Visa Purchase - Receipt 140052In BRISBANE Date 14 May 2020 Card 462263xxxxxx7746,,-379.16,4542.84,379.16
16/05/2020,Internal Transfer - Internal Transfer - Receipt 350267 Savings Maximiser 0046211453,,-1180,4922,1180
16/05/2020,Internal Transfer - Internal Transfer - Receipt 349907 Savings Maximiser 0046211237,,-690,6102,690
16/05/2020,Internal Transfer - Internal Transfer - Receipt 65340 Orange Everyday 0065083812,,-345,6792,345
16/05/2020,Kogan MoneyBlackCard          4813635950084279 - BPAY Bill Payment - Receipt 10888 To Kogan MoneyBlackCard 4813635950084279,,-400,7137,400
15/05/2020,Goodstart Murrum - Direct Debit - Receipt 152434 A0054R8B01MK,,-200,7537,200
15/05/2020,GOURMET MEATS - Visa Purchase - Receipt 157759In MURRUMBA DOW Date 14 May 2020 Card 462263xxxxxx7746,,-50.7,7737,50.7
15/05/2020,DISNEY PLUS - Visa Purchase - Receipt 157758In RICHMOND Date 13 May 2020 Card 462263xxxxxx7746,,-8.99,7787.7,8.99
15/05/2020,BUNNINGS 432000 - Visa Purchase - Receipt 157757In ROTHWELL Date 12 May 2020 Card 462263xxxxxx7746,,-6.88,7796.69,6.88
15/05/2020,MCDONALDS KALLANGUR - Visa Purchase - Receipt 157756In KALLANGUR Date 12 May 2020 Card 462263xxxxxx7746,,-7.35,7803.57,7.35
15/05/2020,Guzman y Gomez North - Visa Purchase - Receipt 157755In North Lakes Date 14 May 2020 Card 462263xxxxxx7746,,-27,7810.92,27
